Esperando vc falar "quero assistir um pipocão só explosão , porrada e testosterona" pra levar velozes e furiosos	Positivo
tipo velozes e furiosos q os cara ja desistiu dos carro e agr so quer sabe de porrada e explosão	Negativo
ontem eu assisti o velozes e furiosos em english ta lgd mas porra ali é só luta e pa e tinha mais explosão q dialogo então tava suave	Positivo
Meu malvado favorito 3 é explosão de fofura! Eu amo demais hauehsksjdjshd	Positivo
explosão de tnts, era jurassica, encantando coisas, minerando, caindo na lava, parkour, luta, batman vs coringa, homem aranha vs venom	Positivo
esse novo homem aranha o diretor diz que tá chei de ideia... já começa errado aí, todo mundo sabe que cinema é explosão carro e mulheril	Negativo
Homem-Aranha de Andrew Garfield acharam exagero a explosão no céu com o "vírus" Lagarto. No novo o piá vira um avião com a teia e tá td ok!	Negativo
@DanielSFurlan @caitomainier não assistam homem aranha . Pouca cena de explosão , muito diálogo adolescente e nenhuma cena de alta velocidade	Negativo
eu+você+pizza+coca-cola+ homem-aranha de volta ao lar= explosão de emoções	Positivo
@benjaminback Vc viu o comercial de um banco? Quebra tabus, uma menina, futebol e a explosão do GOL! #mulhermaravilha #mulhernofutebol	Neutro
Confirmaram Mulher Maravilha 2	Neutro
na hora que doomsday solta uma explosao o batman sai correndo pra de tras do escudo da mulher maravilha KKKKKKKKKKKKKKKKKKKKKKKK	Neutro
do jeito que é a briga entre defensores do frio x amantes do calor parece que se chegar num consenso o clima vai ser aquele pra sempre	Neutro
Defensores da Cersei passem mais vergonha e por favor n tentem matar ngm em uma explosão	Neutro
mano baywatch eh tao bom serio assistam tem mulher gostosa the rock zac efron se fudendo explosão destruição em massa annabeth do percy j.	Positivo
Proofe! Seria certo associar os cangaceiros a uma ideia de mercenários ? Manda beijo aqui pro Sul!! #proenemaovivo @marcelolameirao	Neutro
beijo estilo velozes e furiosos	Neutro
obrigada irmã *levanto e beijo o rosto da anabelle , me sento de novo*	Positivo
Um beijo pra quem sonhou com a freira do Invocação do Mal essa noite e quase morreu de infarto kkkkkkkkk	Positivo
Se eu fosse a Bela do crepusculo n ia ter filme pq amo tanto pão de alho q ia matar meu namorado-vampiro no primeiro beijo	Positivo
Meta de vida é ir com a cremosa na roda gigante e dar aquele beijo do crepúsculo laa no topo	Neutro
Quem nasceu Crepúsculo já mais será Harry Potter. Um beijo de luz pros haters #HarryPotter20	Neutro
Vou tomar banho e ir pro cinema ver Meu Malvado Favorito , beijo .	Neutro
Quer me agradar é me dar beijo na testa, Deus eu fico igual a menininha do meu malvado favorito	Positivo
Um beijo pra quem desistiu da prova de métodos e ta assistindo Meu Malvado Favorito	Positivo
@Letzz12 queria dizer q te odeio por nao ir assistir comigo meu malvado favorito 3, beijo	Neutro
Queria dizer que assisti meu malvado favorito 3, e fiquei apaixonada, beijo beijo	Positivo
hoje eu só queria pegar essa quinta do beijo e assistir a estreia do meu malvado favorito	Positivo
Sdds do beijo dela	Neutro
— Me dá um beijo ? —Mas eu tô gripado. — Deixa de besteira. — É sério. — Na saúde e na doença, lembra?'' — Querido John .	Neutro
— Me dá um beijo ? —Mas eu tô gripado. — Deixa de besteira. — É sério. — Na saúde e na doença, lembra?' — Querido John .	Neutro
HAHAHAHAHAHAHAHA UM BEIJO DE HOMEM ARANHA SUA CAVALA	Neutro
"Eu sempre quis dar beijo de homem aranha " kkkkkkk	Neutro
minha amiga tá assistindo the oc e acabou de terminar um ep que teve referência do beijo de homem aranha fiquei apaixonada que fofo	Positivo
oi bebe me da um beijo pea cada vez que a globo passou homem aranha	Neutro
se eu morrer de passar mal dps das coisas q comi pelo menos vou em paz por saber q cumpri minha meta de dar um beijo estilo homem aranha	Positivo
Grey Worm mandou um beijo pra Mulher Maravilha . O amor é nossa maior fragilidade, e o q motiva nosso heroismo.	Positivo
Mulher maravilha , eu te amo muito , você não faz ideia do bem que me faz, do seu sorriso. Me manda um beijo please	Positivo
Beijo tia vera	Positivo
Acho que eu tava quase te deixando O seu beijo sempre acaba complicando Vou ficar mais um pouquinho por enquanto	Positivo
Cada foto que eu curto eu beijo a tela do celular, se fosse personagem de um desenho seria a mulher maravilha	Neutro
Poderiam ter trocado a atriz americana por você para atuar no filme Mulher Maravilha , 1000 vezes melhor! Bom final de semana! beijo	Negativo
um beijo pra quem administra as contas dos defensores no twitter	Positivo
Boa tarde minha princesa manda um beijo pra o grupo defensores da emilly	Neutro
vou ir assistir o poderoso chefinho , beijo amores	Neutro
Estádio não tem culpa, tem que quebrar carro dos jogadores e diretoria, mercenários do caralho...	Negativo
Tem que quebrar o carro de qtos jogadores/ mercenários pra essas merdas jogarem?	Negativo
Esse grupo precisa de um choque quem não se esforça corta salário time de mercenários estão puxando o carro	Negativo
Eu achava que eu andava rápido com carro , mas seu Henrique é velozes e furiosos naa ruazinhas ahahah	Neutro
Com esse preço da gasolina o próximo velozes e furiosos vai ser só com carro 1.0	Negativo
o que vocês acham sobre velozes e furiosos antes eles eram ladrões de carro e agora eles se tornaram agentes especiais rss	Neutro
meu sonho de princesa é participar de um racha igual desses filmes " velozes e furiosos " com um carro bem foda e todo rosinha	Neutro
menino sla.. eu acho muito humor de hetero.. ai coloca os carro e mulher gostosa no meio parece que to vendo velozes e furiosos .. gosto não	Negativo
Confesso que depois que comecei a dirigir e comprei meu carro , um dos meus filmes favoritos é velozes e furiosos , nem vou dizer o porque	Positivo
Depois sonhei que eu ia pro cinema assistir um filme q eu não lembro, ai aparecia a anabelle dirigindo um carro pra promo o filme ?????	Neutro
*entro, coloco o cinto e ligo o carro * vamos? *ligo o som e sigo para a escola*	Neutro
*respiro fundo* vai dar tudo certo *rio e vou em direção ao meu carro e coloco minhas malas na mala do carro * vamos malia traz sua mala	Neutro
acordei atrasada, o pneu do carro furou, fui arrumar e tive que trocar os dois dianteiros, fiquei mais de 1 hra na borracharia, q dia ein	Negativo
Kelly disse que carro é com k, mds kkkkkkkkkkkkkkkkkkkkkkkkk	Neutro
Pegar o carro amanhã e levar os menino no cinema vê meu malvado favorito	Neutro
Quero ir no cinema assistir meu malvado favorito 3 com meu irmão, porém não tenho carro e o shopping continente é longe	Negativo
meu carro malvado favorito 6	Neutro
Amanhã vou ir pra Guarapuava com a mãe pra fazer revisão do carro e assistir meu malvado favorito 3 com meu irmão	Neutro
Carro 3, homem aranha, e agora meu malvado favorito quem aguenta ? Só meu namorado mesmo	Positivo
Tenho q ir ver logo meu malvado favorito é carro 3 mlk	Positivo
RT ‘ Meu Malvado Favorito 3’ e ‘Homem Aranha: De Volta ao Lar’ continuam em cartaz. O simpático carro de corrida, o lendário Relâmpago McQu…	Neutro
tô doido p ver meu malvado favorito no cinema mano, tomara q o carro do meu pai fique pronto logo kkk	Positivo
Meus pais falaram que íamos assistir Homem-Aranha mas quando chego no carro descubro que vamos assistir outro filme	Negativo
aquele momento q cê tá largada no sofá comendo salgadinho mexendo no celular, toca a música da mulher maravilha no carro de som na rua	Positivo
o famoso carro da mulher maravilha	Neutro
Vou pegar o carro hoje, meu Deus nem acredito	Positivo
To sendo mas invisível que o carro da mulher maravilha	Negativo
Minha mãe saiu do cinema dps de ver mulher maravilha cantando pneu e falando que o carro tava cheio de fogo	Positivo
Hoje passou um carro e gritou "olha lá a mulher maravilha " kkkk eu ri mt	Positivo
ou seja, agora vou sair na rua correndo igual o usain bolt e se vier um carro eu vou virar a mulher maravilha e voar, pq é o q dá p fazer	Positivo
Estamos tipo se beber não case ... Descobrir que abastecemos o carro 2:30 da manhã ou seje esse horário minha irmã já não tinha carteira!	Neutro
Ano passado teve os defensores de vidraça do Beira-Rio e de carro do Carraveta. Tem que colocar dedo na cara sim e tirar de lá a força.	Negativo
@jornal_cultura 1970 EM MEU CARRO TINHA BRASIL AME O OU DEIXE O. ACHO QUE VOU DEIXA LO NAS MÃOS DOS DEFENSORES DAS DIRETAS JA	Negativo
Eu vou quebrar o carro de todos os defensores desgraça pelada	Negativo
Hoje é um daqueles dia que só quero pegar o carro , colocar um som e só parar na praia, ficar observando o mar Mas aí eu acordei	Negativo
O carro pegou fogo lá no Bar celona mano kkkk	Neutro
Passando na rua, e vi o carro balançando tem gente metendo, tem gente metendo	Neutro
Vim lavar meu carro no shopping e aproveitei pra ir no cinema ....o único filme disponível no horário era Baywatch .	Negativo
Vcs precisam sair desse mundinho de vcs q 18 anos eh td de bom.. faculdade n eh american pie e cnh e carro n cai do céu	Negativo
podem até me chamarem de crazy, mais não sabe aonde nós vai, no carro já tá tipo have, nós tá tipo american pie ..	Neutro
Vcs precisam sair desse mundinho de vcs q 18 anos eh td de bom.. faculdade n eh american pie e cnh e carro n cai do céu	Negativo
meu carro ja ta tipo rave nos ta tipo american pie	Positivo
Da primeira vez que vi Velozes e Furiosos eu achava que a Letty e do Dom eram irmãos. Tomei mó susto quando eles se pegaram.	Neutro
UM GATO SE TACOU NO MEU PORTÃO, QUE SUSTO DO CARALHO	Negativo
levei um puta susto no trailer da Anabelle 2	Positivo
E tbm acho q esse Anabelle 2 ai vai barrar o primeiro, sdds tomar susto	Positivo
levei 3 susto assistindo o trailers de anabelle . Já quero ir na estrela desse filme	Positivo
Anabelle ? O chamado?? Eu pego cada susto é com o Herobrine aparecendo atrás do @DCZINHU e o @C0RUJ4YT gritando na série paranormal.	Negativo
Mano..fomos pro sítio (pensa num breu) daí assistimos invocação do mal 2...Justo na parte de susto , não me entra um gato preto pela janela	Positivo
Acabei de olhar invocação do mal 2.... Tomei cada susto com os meus dindos e minha mãe.... Kkkkkk.....	Positivo
Acabei de assistir invocação do mal 2, eu n senti medo, só levei susto , mas a história em si é massa	Positivo
Eu assisti invocação do mal 2 pela 11° vez de madrugada. Meus irmãos tudo gritando de susto e eu só rindo.	Positivo
só pq eu tomo susto não quer dizer q seja bom KKKKKKKKKKKKKK invocação do mal é horrível, tanto o 1 quanto o 2	Negativo
Fui ver invocação do mal um dia no cinema. Único susto que eu tomei foi o preço da pipoca. 18 conto	Negativo
to assistindo invocação do mal 2 com as gurias, millena ta deitada cmg e cada susto que ela leva ela se gruda em mim	Neutro
tô assistindo invocação do mal 2 pela milésima vez e ainda tomo susto nessa merda	Positivo
o gps do celular do meu pai tá com a voz do gru do meu malvado favorito e, toda vez eu levo um susto quando ele começa a falar	Neutro
A mina me faz assistir meu malvado favorito e ainda toma susto com o filme, tá de sacanagem	Negativo
Tem tanto tempo que eu tô usando essa máscara do homem aranha que quando eu tirar vou levar um susto com a minha cara	Positivo
Toda hora tomo susto com com esse homem aranha do Arthur voando	Negativo
O " homem-aranha " me deu um susto	Neutro
saiu um cara vestido de homem aranha da porta atrás de mim, levei o maior susto	Negativo
NOSSA QUE SUSTO , PENSEI QUE FOSSE O FILME DO LIXO HOLLAND OFSDOIFJOISDFIOSDK homem-aranha pra mim só o Tobey Maguire e essa série, desculpa	Negativo
Fui assistir homem aranha terminei assistindo a múmia, só do susto do gordinho no final valeu a pena KKKKK KKK PQP	Negativo
Eu tomei muito susto vendo homem aranha	Neutro
Só eu mesmo para tomar um puta susto no cinema assistindo Homem-Aranha (odeio cena que tem um suspense)	Negativo
sobre colocar o tema de mulher maravilha como despertador: levei um puta susto	Negativo
Porque você não me falou que o lupus fazia mulher maravilha @leandrofreythas ? Levei um susto hahahaha	Positivo
eu me distraí assistindo doctor who e tomei um susto pensando que tinha perdido o painel de defensores , ainda bem que é só amanhã	Positivo
Eu achava q faculdade era q nem american pie , tomei um susto quando entrei e vi que realmente é	Negativo
Jogadores não sejam mercenários e honrem a camiseta que pagam o seu salário!!! Que vexame, devolvam meu Inter pelo amor de Deus.	Negativo
vcs n tem noção do meu amor por velozes e furiosos sério eu fico doida assistindo	Positivo
espero que nosso amor dure mais que a franquia velozes e furiosos	Positivo
" Amor vai devagar, tu acha que é pilota de Velozes e Furiosos ? Tamo no filme não, tudo bem q vc ta careca igual o Toreto" kkkkkkkkkk	Neutro
Velozes e Furiosos 5 amor esse filme	Positivo
Se existe historia de amor mais verdadeira que a do dom e a lety no velozes e furiosos , ainda tá pra nascer	Neutro
O engraçado é que ela parece a boneca anabelle , mas mesmo assim ele preferiu ela. Será amor ?	Neutro
Tô assistindo" invocação do mal 2 "com meu amor	Neutro
a mulher de invocação do mal e erica hahn são um casal nesse filme ui pelo amor	Neutro
Qualquer um podia estar agora assistindo comigo invocação do mal sem ser meu irmão pq pelo amor de Deus menino fica me dando susto	Negativo
por exemplo invocaçao do mal PUTA FILME BESTA PELO AMOR e o chamado tbm é idiota pra cacete VAMOS FAZER FILMES DE TERROR BONS GALERO?	Negativo
o invocação do mal é bom! Vera farmiga meu amor <3	Positivo
Difícil,adoro filmes hehe assisto e já me apaixono e pronto,meu nenêe.egosto de vários e gêneros diferentes,Ironias do amor , invocação do mal	Positivo
Eu e a banana, a banana e eu..... Uma história de amor melhor que crepúsculo ♡	Negativo
eu sou mt kkkkkkkkkkk detalhes e eu historia de amor melhor q crepusculo	Negativo
@ProfRFelicio e os ''''SUPER CONFIÁVEIS"" sites com domínio ".wordpress", uma história de amor melhor que Crepúsculo	Negativo
passei o dia com a vida, e assistimos meu malvado favorito 3 no cinema aaaa um amor	Positivo
E te acordar não eh tão fácil meu amor hsjshs	Neutro
espero q n seja eu nea, pq ir até o tatuape pra ver meu malvado favorito é uma prova de amor djdjskks	Positivo
Assisti meu malvado favorito hoje Que filme mais amor	Positivo
amor : Mussarela ou lanche? Maroco: Mussarela né amor Maroco: Sem dúvidas amor : Meu pai disse lanche aoxkoa Se quer guerra terá	Neutro
[24/7 18:37] amor : [24/7 18:38] Maroco: De onde esse coração [24/7 18:38] amor : Do meu cu Carinhosa!	Neutro
Vou no paragem com meu primos ver Malvado Favorito , q amor	Positivo
Eu te prometo que tudo vai acabar antes do que imagina. — Querido John	Neutro
É que eu sou uma pessoa difícil de lidar, de conviver, de amar. — Querido John	Neutro
A gente precisa acreditar que tudo vai dar certo. — Querido John .	Positivo
Eu preciso ver muito: Querido John , Um Porto Seguro, A Vida e Morte de Charlie e ABC do Amor .	Neutro
Um espaço entre nós, Marley & eu, Um amor para recordar, Querido John , A última música, A culpa é das estrelas (chorei em todos)	Positivo
Assisti Homem - Aranha com o meu amor	Positivo
Vou no cinema hoje com meu amor ver homem aranha kkkk	Neutro
Quando for assistir homem aranha , pelo amor de deus Veja os créditos	Neutro
devolve meu amor não correspondido	Negativo
Mais amor ao falar. Mais paciência ao ouvir.	Neutro
Quando o amor for tudo que restar, então aí teremos tudo.	Positivo
Só o riso, o amor e o prazer merecem revanche. O resto, é mais que perda de tempo ... é perda de vida.	Neutro
LK- meu amor , melhor pessoa, amo demais, bela kkk, Leãozinho e minha mulher maravilha	Positivo
Mulher-Maravilha dizendo que a guerra acaba com amor , sendo que a mesma termina enfiando a porrada em todo mundo	Negativo
"Só o amor pode salvar o mundo" Mulher Maravilha	Positivo
Vou te esperar passe o tempo que for Deixe bem guardado esse nosso amor Sei que eu te mereço	Positivo
Fala a verdade aí, assume que eu já virei amor	Neutro
Ganhei uma brusinha da mulher maravilha , muito amor por aquela camiseta	Positivo
Vamos manter o amor a Mulher-Maravilha vivo que a continuação tem que bater bilhão e ser maior que qualquer herói macho vivo	Positivo
Mais “Agora eu sei que só o amor pode salvar de verdade o mundo.” — Mulher Maravilha	Positivo
Quero deixar registrado aqui meu amor pelo filme: Se beber não Case , e Última viagem a Vegas	Positivo
Se beber não case kkjk	Positivo
Fica comigo/o melhor de mim/ amor e outras drogas/ sexo sem compromisso/ se beber não case 2	Positivo
Bom dia aos homossexuais e defensores , a cada dia damos um passo a frente combatendo o preconceito. Toda forma de amor é justa.	Positivo
o poderoso chefinho é tão amor	Positivo
assisti o poderoso chefinho com o meu amor , esse filme é tão lindinho	Positivo
Acabamos de ver, eu e meu amor — assistindo O Poderoso Chefinho	Positivo
Como tcheca piscando louca pra fazer amor	Neutro
assisti O Poderoso Chefinho e entendi o amor que o @classic1real tem por esse filme	Positivo
Eu e meu amor estávamos assistindo o poderoso chefinho esse filme é mt fofo rs	Positivo
Tô vendo O poderoso chefinho , onde o personagem é a cara do Louis!!!!! Ai, que amor pqp	Positivo
Amanhã vou ver Baywatch com o meu amor !!	Neutro
Amor eterno a Zac Efron #Baywatch	Positivo
eu tenho que assistir BAYWATCH pelo amor , quem marca de ver comigo	Positivo
vim assistir baywatch sozinho no cinema isso chama amor a zac efron	Positivo
Espero mt q nao tenha foto minha pelo amor de Deus pq meu passado me condena	Negativo
Eu nem vejo direito e chorei com Renato dizendo q ele precisa viver aquele amor ...ai,não tenho estrutura pra isso... meu passado me condena	Positivo
Cansei de te dar valor FALEIIIII TCHAU E BENÇA AMOR sempre que tocar isso vai vir a frase " meu passado me condena " na minha mente	Positivo
amor hoje vai passar nosso filme sabia aquele em nós somos protagonistas meu passado me condena o nome	Positivo
@vihbitler • Linda dmssss • Conheço ja não é de hoje • " Meu passado me condena " • Um amor de pessoaaa • Fecha pra quem fecha com ela	Positivo
29- Tenho várioss mas vou tentar falar alguns, amor sem fim, o chamado (todos), piratas do Caribe, truque de mestre, meu passado me condena	Positivo
pelo amor de deus alguém vai assistir comigo meu passado me condena c o fábio e a miá mello no teatro	Neutro
Queria muito compartilhar aquele vídeo do cara falando do amor entre pretos, mas o problema é que meu passado palmiteiro me condena .	Negativo
Tô assistindo american pie o livro do amor	Neutro
Vou assistir American Pie - o livro do amor na Netflix	Neutro
estou assistindo american pie o livro do amor	Neutro
American pie 7: o cu do amor	Negativo
bye bye miss american pie	Negativo
american pie >>>>> o livro do amor	Neutro
American pie o livro do amor é o melhor filme aaa	Positivo
"Filme de herói esta saturado demais,ja ta chato" - Diz a pessoa que edta indo ver velozes e furiosos e transformers	Negativo
Vai ser um Velozes e Furiosos de super herói	Neutro
Coisas q já passou da hora de Hollywood parar: King Kong Planeta dos Macacos Transformers Velozes e Furiosos Filme de Herói sem roteiro	Negativo
Top 5 filmes de herói : -Homem Aranha 2 - Velozes E Furiosos : Tokyo Drift -O Ninja Didi E A Princesa Lili -Segurança Nacional -Plano Real	Positivo
Só falta virar super herói agr p ficar que nem velozes e furiosos	Negativo
eu acho que minha relação com velozes e furiosos melhorou muito quando eu aceitei que é um filme de super herói	Positivo
Velozes e Furiosos : o filme em que ter carteira de motorista é quase ser super herói kkkkk	Neutro
olha o heroi salvand q coisa + crepusculo	Negativo
no cinema agora: baywatch, a múmia, carros 3, meu malvado favorito 3 + 2 filmes de super herói . ah claro tem um filme com o tom hanks tb.	Neutro
MANO PARA eu queria comprar meu malvado favorito 3, mas o idiota quis homem aranha e eu odeio filme de super heroi me ajuda	Negativo
já vi (vini adora filme de super heroi ) .. quero ver o circulo e o meu malvado favorito :B	Negativo
De super herói não, miga, vamo assistir meu malvado favorito 3 <3	Neutro
RT Longa mostra o retorno do herói ao cinema. ‘ Meu Malvado Favorito 3’, ‘Mulher Maravilha’ permanecem em cartaz.	Neutro
RT Jovem super- herói tenta retomar vida adolescente após atuar com Vingadores. Animação ‘ Meu Malvado Favorito 3’ e comédia ‘Meus 15 anos’ …	Neutro
Simmm homem aranha é meu herói chodó e meu malvado favorito , animação e Emma Watson pobre estouuuu pobre estouuuuu	Positivo
Querido john , anjos da lei, magic mike, para sempre, ela dança eu danço, o ataque, legião perdida, anti- herói e muitos outros, t amo gostoso	Positivo
to em duvida meu heroi preferido eh homem aranha ou flash	Positivo
mano que raiva ,,, ai eu tive que assistir homem aranha só que eu não sou mto fã de filme de herói	Negativo
RT @thaeps Homem-aranha sempre sendo o melhor herói já feito!!!	Positivo
criei expectativas pra homem-aranha nem gostei tanto assim, wonder woman fui só assistir e foi o melhor filme de super- herói q vi esse ano	Neutro
E as intenções do Homem Aranha são sempre boas, por isso ele é meu herói favorito	Positivo
Espero que esse filme dl homem aranha seja fodaaaaa pq ele é o melhor heroi do mundo	Positivo
pega deadpool ai então, apenas com 1 heroi conseguiu bater mais que mulher maravilha	Positivo
Só estranhei o momento em que se dá Mulher Maravilha como exemplo de filme de super herói bom, em contraposição a BvS do Snydeus...	Neutro
Vamos manter o amor a Mulher-Maravilha vivo que a continuação tem que bater bilhão e ser maior que qualquer herói macho vivo	Positivo
Ainda tenho de assistir mulher maravilha , estou super atrasado nos filmes de super herói . #ALigaSeUniráNoSDV	Neutro
unico filme de super heroi que engoli em tempos foi mulher maravilha e o xmen, carregando esses chatos nas costas	Negativo
Eu tenho um pouco de medo, mesmo depois de Mulher Maravilha , de um filme da DC com mais de um héroi	Negativo
Depois da obra prima de Mulher Maravilha , não sei mais o que esperar de um filme de herói .	Neutro
Só mulher maravilha memo. Fomos assistir homem aranha meu herói do coração e ODIEEEEEEEEEI FORTE	Negativo
Queria que os defensores fosse um ep pra cada herói pq aí eu podia assistir só os de jessica jones sem ter que aguentar o demolidor e etc	Negativo
Aliás, única de herói que fico de olho. Curtia Arrow, mas virou novela ruim. Talvez, em Defensores saia algo legal também.	Negativo
no cinema agora: baywatch , a múmia, carros 3, meu malvado favorito 3 + 2 filmes de super herói . ah claro tem um filme com o tom hanks tb.	Neutro
Romance - sou louco por você Ação - os mercenários / Nerve Terror - pesadelo /espelhos do mal Festas- Vizinhos, XOXO	Neutro
O Guto colocou velozes e furiosos 7 p gnt assistir, agora tô chorando. Como vingança vou colocar um romance	Positivo
Esses filmes de romance tão mto chato, galera paia, vou por um velozes e furiosos aq pq vin diesel é sucesso	Negativo
Como vê romance agarrada se meu namorado quando vem pra cá só quer ver velozes e furiosos 7 e filme de guerra? Não dá né	Negativo
Acbei de ver invocação do mal , nem parece q ja tinha visto, agora vou ver um de romance pra acabr cm clima de: me caguei tdddd	Positivo
29- romance : simplesmente acontece, suspense: hush a morte ouve, terror: invocação do mal 1	Neutro
a gente viu invocação do mal 2 quando as luzes se apagam esquadrão suicida e um filme de romance lá que toca Imagine Dragons	Neutro
Uma história de romance mais bosta que crepúsculo	Negativo
kkkkk iludir não eu sou livre pae, quer romance compra um livro do crepúsculo kkkkk serenao	Negativo
Crepúsculo seria um bom romance se não fosse fadas e Ney Matogrosso	Negativo
A Hospedeira seria um livro 100% se não fosse o romance meloso e o triângulo amoroso, mas a autora não conseguiu se desprender de Crepúsculo	Negativo
quer romance ? ver crepúsculo rsrsrsrs	Negativo
Eu amo filmes clássicos de romance , tipo titanic, Romeu e Julieta, querido john e etc	Positivo
Querido John é o melhor filme de romance	Positivo
falei que nunca mais ia assistir nenhum filme de romance , e acabei de colocar " querido John " pra assistir.. q merda!!	Negativo
Pela primeira vez voltei a assistir filme de romance e estou vendo Querido John , eu não sei lidar com esse filme	Positivo
querido john e simplesmente acontece vão ser meus filmes de romance preferido pra sempre, sério	Positivo
eu kkkkk, meu livro fav é Harry Potter, mas de romance acho que é querido John e o seu?	Positivo
não. Mas olha romance tem "A culpa é das estrelas" " querido John " "simplesmente acontece" "cartas pra julieta" "como se fosse a primeira vez	Neutro
Critica do meu pai ao novo filme do homem aranha : Gostei mais do primeiro Porque tinha mais romance . Até tu pai?	Negativo
Igor falou "amor, vamos ver de volta ao lar?" aí disse "claro". Cheguei lá e descobri q era homem aranha . Achei que era romance , fui trouxa.	Negativo
KKKK ta tocando bad romance no fone e eu acabei de ver um gif do homem aranha dançando, parecia q ele tava dançando lady gaga	Positivo
/222222 só troca o romance por homem aranha *	Positivo
e eu que tava vendo homem-aranha achando q era romance teen?	Negativo
o bom desse homem aranha é que n teve romance forçado igual nos outros	Positivo
me falaram que no filme da mulher maravilha tem romance e eu achando que era só ela lutando contra tudo e tals	Neutro
"Ah mas se tem nos quadrinhos..." foda-se os quadrinhos! Mulher Maravilha é muito massa pra ser ofuscada por essa baboseira de romance	Positivo
Se Batman Vs Superman já foi confuso imagina explicar o romance do Aquaman com a mulher maravilha , explicar o Super man fracote e o BatPai	Neutro
Hj eu passei a tarde assistindo mulher maravilha e depois filme de romance , chorando horrores por sinal	Positivo
ela eh linda miss miss miss nosso lance daria um filme mas nao eh romance eh xis xis xis	Positivo
Mulher maravilha foi um filme ótimo Seria melhor sem o romance mas fora isso foi otimo	Positivo
um insuportável, mega sem graça. Espero que no filme Liga da Justiça não tenha muito foco no romance dele com a mulher maravilha	Negativo
Meu amigo dando pala deu revoltado com o romance forçado do filme da mulher maravilha	Negativo
zach galifianakis(gordo do se beber não case ) é o melhor tanto em drama, romance ou comedia,ja amava esse gordo,depois desse filme slc	Positivo
Cade nossa comedia misturada cm suspense e romance ? ( Se beber nao case é mt bãun)	Positivo
tem que ter romance ... Não afetando o plot dos defensores , tá ok. É o único que tô no aguardo.	Neutro
velozes e furiosos , melhores filmessss	Positivo
o ano é 2054 o mundo está em guerra falta de recurso desigualdade social facismo velozes e furiosos 31 estreia	Neutro
Velozes e Furiosos : ̶G̶u̶e̶r̶r̶a̶ Corrida nas estrelas	Neutro
guerra dos tronos e crepúsculo é tudo a mesma merda todas treta só aconteceu por causa de um namorico adolescente	Negativo
acabei de ver o último filme do crepúsculo e to chateado q a guerra final foi só uma visão	Negativo
JESUS! eu não lembro do final de crepúsculo , só lembro da guerra que ia ter mas a Alice mostrou pro cara que ele ia morrer	Neutro
Fui com minha melhor amiga ver meu malvado favorito 03 e domingo vamos com os meninos ver transformes	Neutro
Vou ir ver meu malvado favorito 03 com minha melhor amiga amanhã	Neutro
Nossa é homem aranha carros meu malvado favorito vai lançar agora aquele no limite da fuga, vai lançar um de guerra também tanto filme	Neutro
Meu malvado favorito 3 é muito bom sissjsjsnsis	Positivo
Quero assistir Meu malvado favorito 3	Positivo
Pensei que a primeira cena do Homem-aranha em Guerra Finita seria uma longa conversa do Peter com a Tia May.	Neutro
meu afilhado tinha pedido boneco do venom com língua pra fora eu dei e agora ele falou q quer o homem aranha da guerra civil	Neutro
Eu desisti desses filmes desde guerra civil, so vi mulher Maravilha no cinema pq pra dar errado a Warner tinha que se superar	Neutro
Mulher-Maravilha dizendo que a guerra acaba com amor, sendo que a mesma termina enfiando a porrada em todo mundo	Neutro
Ja podemos falar que o filme da Mulher Maravilha não era tão bom assim?	Negativo
agora não sei se vou de mulher maravilha ou guerra civil	Neutro
Passar a madrugada assistindo filme de guerra só reforça a minha vontade de ser militar. Mas o Brasil não da valor aos seus defensores .	Neutro
Assisti velozes e furiosos 8 agr e QUE FILME! Final emocionante	Positivo
É sempre emocionante assistir velozes e furiosos 7	Positivo
achei carros 3 mais emocionante que velozes e furiosos 8	Neutro
Essa música da trilha de velozes e furiosos é muito emocionante.	Positivo
Ainda estão pra fazer cena mais emocionante que a cena final de Velozes e Furiosos 7.	Positivo
Agr eu tô só o Vin Diesel e o banho é o Paul Walker naquela emocionante cena final de Velozes e Furiosos em que cada um segue pra um lado	Neutro
Assiste Anabelle no cinema pra você ver hauahuaahua mais emocionante que a barca do hopi hari, coração para umas 10 vezes	Positivo
Jogo tá mais emocionante do que o final de crepúsculo	Negativo
Final do " meu malvado favorito 2 " emocionante	Positivo
Homem-Aranha foi um excelente filme, porém Carros 3 conseuiu ser bem mais emocionante !	Neutro
ver a abertura da marvel tocando a música tema do homem aranha no cinema foi muito emocionante	Positivo
Homem aranha era mais legal e emocionante no tempo do GIBI quem é desta época vai lembrar. Hoje é muito fajuta as histórias,	Negativo
O filme é foda, é beirando a perfeição, é engraçado, tem ação, é emocionante , é O HOMEM-ARANHA !	Positivo
E o começo do filme com a música do homem aranha ? NOSSAAAAAAAAA... já tinha visto aqui mas no cinema é.. EMOCIONANTE !!	Positivo
Amei demais Spider Man Homecoming! Filme divertido, emocionante , bem escrito, o Homem-Aranha mais verdadeiro que já vi no cinema!	Positivo
Hoje foi a segunda vez que eu vi homem aranha , não foi tão emocionante como na primeira vez	Neutro
Vim aqui dizer o quanto o filme da Mulher Maravilha é maravilhoso, perfeito, lindo, emocionante , e me deixou sem palavras depois #chorei	Positivo
Fui no praia assistir meu malvado favorito 3 c direito a muita pipoca, risada e a família toda reunida qro mas o que?!	Positivo
Gente, vi o filme de mulher maravilha e puta que pariu, representatividade importa pra caralho, chorei na cena da praia , mulheres fodas!	Positivo
Filme de super heroi não é muito minha praia entao fui esperando nada de mulher maravilha e meus amigos, ganhou meu core	Positivo
Cara, ver essa galera lutando em equipe , o homem-aranha junto, caraca, é tudo muito surreal	Positivo
Só queria dizer que amo os Defensores demais e to surtando com o novo trailer! QUE EQUIPE DA PORRAAA	Positivo
Teve drama, teve humor, teve luta , teve o clássico e moderno ao mesmo tempo homem aranha FOI UMA EXPERIÊNCIA ÚNICA	Positivo
A mulher maravilha é a única da liga da justiça que luta no estilo break dance	Neutro
já assistiu aquele que luta todas contra a mulher maravilha ? é o melhor bicho	Positivo
Essa mulher maravilha é muito maravilhosa mesmo! Luta , luta , luta e o cabelo continua ali, impecável!	Positivo
Porém, acho que os Defensores pode ter uma pegada muito melhor, porque além de ter mais tempo não precisa focar só na luta principal	Negativo
Aí mano, quero ver meu malvado favorito 3	Positivo
meu bebê me levou para ver meu malvado favorito , nem gostei	Negativo
Sobre o filme O Poderoso Chefinho : Eu sou o bebe grandão que tanka e come biscoito. HAHAEHAUEHEA foda !	Positivo
Assisti ontem o Boss Baby/ Poderoso Chefinho e pelo que entendi é que [SPOILER] o primeiro bebê morre, dai o outro é um segundo irmãozinho+	Negativo
"Biscoito é para quem vende". Divertido e inteligente! O Poderoso Chefinho - DVD Um bebê falante que usa terno...	Neutro
- o poderoso chefinho (ok) - casamento grego 2 (ok) - o bebê de Bridget Jones (ok) 	Positivo
Eu fui assistir o poderoso chefinho , isso quer dizer que eu sou o bebê mandão?	Neutro
O PODEROSO CHEFINHO Disponível para locação na Planeta DVD Livraria. Um bebê falante que usa…	Neutro
A DC é horrível pra fazer filme.	Negativo
[7/11, 21:45] carly: tô veno american pie [7/11, 21:52] mamis: Ta na hora de bebê dormir! [7/11, 21:52] carly: sou um bebê que faz bebê flor	Neutro
Na vida eu sou aquele cara do american pie q é certinho e bonitinho, mas quando bebe vai parar la no haiti e volta c uma criança	Neutro
Pior é os caras dizendo que o filme era horrível ...não tem capacidade mental de entender Velozes e furiosos e querem dar opinião sobre esse	Negativo
achei o teaser de jogador Nº 1 tão horrível . serei muito criticado, mas que bosta é uma mistura de velozes e furiosos com transformes, tchau	Negativo
tentando ver velozes e furiosos 7 pelo tel, horrivel kk	Negativo
E também faz essa coisa horrível chamada Ivã que assiste Velozes e Furiosos sempre que sai no cinema.	Negativo
TWD é igual Velozes e Furiosos : é horrível , ninguém gosta mas tem 95 continuações/temporadas	Negativo
minha mãe tá num velozes e furiosos sem óculos e caindo uma chuva horrível É nois se eu sair viva	Negativo
seria melhor se fosse ele, eu acho, porque foi aquela música horrível de chata a primeira ouvida de Velozes e Furiosos	Negativo
+ ( velozes e furiosos ), como tem pouca sessão pra muito filme, um ou outro não passa aqui mas tirando o 3D que é horrível e isso aí é 10/10	Negativo
Cara tive um sonho horrível com a anabelle	Negativo
POR QUE EU IA TE RECOMENDAR ANABELLE ? AQUELE FILME É HORRIVEL 	Negativo
só pq eu tomo susto não quer dizer q seja bom KKKKKKKKKKKKKK invocação do mal é horrível , tanto o 1 quanto o 2	Negativo
Dia horrível pra escolher assistir invocação do mal 2	Negativo
O boneco do mal (da medo pra krl) Invocação do mal 2 (da só uns sustinhos) NAO ASSISTE OUIJA, O FINAL É HORRÍVEL (pelo menos eu achei)	Negativo
Eu gosto de invocação do mal também, os dois!!	Positivo
eu sonhei todo o filme invocação do mal cmo se eu tivesse vivendo ele ou vendo dnv e foi horrível	Negativo
O amor de Zé Ricardo pelo Márcio Araújo dava uma trilogia horrível , estilo Crepúsculo	Negativo
Crepúsculo é horrível , aquilo não é um vampiro, é uma fada é isso!	Negativo
Que filme horrível , vou chamar de Crepúsculo	Negativo
Esse tempo melancólico chuvoso é horrível , parece que tô preso no filme Crepúsculo	Negativo
esse cara é horrivel mano nao tem expressao nao tem nada parece a kristen stewart em crepusculo	Negativo
gente desculpa eu to rindo de vcs falando que choraram assistindo crepusculo eu so uma pessoa horrivel eu sei	Negativo
"Ai crepúsculo é horrivel " "Ai é de menininha" Ta achando ruim n lê Eu vou continuar gostando Vai toma no cu Obrigada	Positivo
Como eu já gostei de crepúsculo gente?? Q saga mais horrível	Negativo
Que morte horrível . Filme podre — assistindo Meu Malvado Favorito 3	Negativo
mano, é horrível ! o novo meu malvado favorito também, tudo uma bosta! 	Negativo
Não faz isso, o filme é horrível , assiste meu malvado favorito 3	Neutro
Não sei se sou uma pessoa horrível por isso mas eu não gostei muito de meu malvado favorito 3 não	Negativo
Eu vi com a Letícia sábado, achei horrível kkkkkkk é melhor tu ver carros ou meu malvado favorito	Neutro
Meu Malvado Favorito 3 é horrível , Jesus!!!!!	Negativo
Meu malvado favorito é horrível ... Morte aos Minions	Negativo
Aquela dúvida horrível em assistir Meu malvado favorito 3 ou Carros 3... mds qual eu escolho rindo de nervoso	Neutro
E se faz merda na primeira vez fica o horrível pra sempre	Negativo
Horrível ter que ler isto. O cara cantava com a alma	Negativo
John volta pro 169 , s2 Amor — Pretendo .. Motivos, notas horrível	Neutro
A adaptação de Querido John ficou horrível .... sorry not sorry	Negativo
Homem aranha é muito bom, mas que dublagem horrível irmãozinho	Positivo
homem aranha que final horrível	Negativo
Meu deus, quem disse que o novo filme do Homem-Aranha é bom? Que filme horrível !!!!	Negativo
Vocês vão me desculpar, mas Homem Aranha 3 é horrível	Negativo
Esse jogo do Homem Aranha novo parece muito legal, tirando o fato de q parece que é horrível voar com as teias. Então, não parece tão legal	Positivo
Ontem fui assistir homem aranha em 3D sai com uma dor de cabeça horrível	Negativo
Homem aranha tá horrível	Negativo
Homem aranha lesadão, ficw com uma camera gravando tudo, com umq fantasia horrivel	Negativo
Tu é horrível — Se apresenta aí então, mulher Maravilha 	Neutro
sim é horrível lutar contra ele bicho sempre perco só consigo ganhar dele com a mulher maravilha	Neutro
Definitivamente, nunca vou gostar de filmes de super heróis, com exceção da trilogia Batman do Nolan. " Mulher Maravilha " é HORRÍVEL .	Negativo
Os únicos filmes da DC que prestaram foram Batman (a série de Cavaleiro das Trevas) e Mulher Maravilha .	Positivo
eu tenho, te entendo é horrível , ruim mesmo é qnd da falta de ar	Negativo
É horrível não ter fotos p postar hahahaha	Negativo
O tipo de homem representado por esse marido da Lília Cabral é horrível . Fazer que é para agradar burros, não é bom. #AForcadoQuerer	Negativo
Também não quero Mulher Maravilha mudando, nem Lara Croft, muito menos Black Mamba de Kill Bill. Descaracterizar personagem é horrível	Negativo
Eu ficava indignado com os defensores do Mancini, o Jandrei é o maior exemplo de como ele era horrível	Negativo
E horrivel saber qual e o verdadeiro objetivo de alguns defensores do aquecimento global... #tojuntocomoRicardoFelício	Neutro
Tá legal que eu sou um dos defensores de que a Diana precisa de um uniforme melhor , mas esse do Straza e horrível de tudo	Negativo
FLAMENGO passando vergonha no brasileiro, e vejo os defensores de jogadores atuando por aqui, time horrível , lampejos de jogos bons.	Negativo
Só imagino como será os defensores com esse punho de ferro horrível	Negativo
eu achei horrível dormi em quase todos os ep mano vi td só por causa de defensores	Negativo
Comecei a assitir esse filme Poderoso Chefinho e não conseguir terminar de assistir porque o começo já é horrível	Negativo
meu deus eu vi a atuação dessa mulher em baywatch e foi horrível	Negativo
Você me condena pelo meu passado horrível , e me julga pelas atitudes do presente.	Neutro
Campari é igual filme ruim ótimo tipo Mercenarios	Positivo
É um filme ruim ruim, Breno, não é um filme ruim foda de ótimo como, por exemplo, Mercenários .	Positivo
opaaaaa, eai gente pra quem curti tbm um otimo programa pra hoje os mercenários !!!!	Positivo
ah não vou precisar vir com o carro igual velozes e furiosos otimo sem multas pra mim, espero que esses ´problemas´ não sejam graves bj	Neutro
Gostei do filme Velozes e furiosos 8, é otimo .	Positivo
acho velozes e furiosos ótimo mas tá na hora de acabar	Positivo
Cá estou eu vendo Velozes e Furiosos 8 logo depois de ter visto Orphan Black tudo ótimo pra um domingo	Neutro
VELOZES E FURIOSOS 8 EH ÓTIMO	Positivo
Quando vejo alguém falando que velozes e furiosos é um ótimo filme	Positivo
Que filmão da porra velozes e furiosos 8, bem surreal, mas continua ótimo kk	Positivo
E se Velozes e Furiosos fosse no Brasil? Seria Velozes e arretados..	Neutro
Ótimo diretor que escolheram pro Shazam. Quando as Luzes se apagam é foda e Anabelle 2 parece ser bem bom.	Positivo
Annabelle: A Criação do Mal tá mais pra Invocação do Mal 1 e 2 q pro primeiro Annabelle, o q é ótimo . Parada tensa. #ScareDiego #Annabelle	Positivo
invocação do mal eh ótimo	Positivo
invocação do mal nd barra, esse filme é ótimo	Positivo
Invocação do mal é ótimo , filme de terror é maravilhoso	Positivo
Invocação do mal 3 eh confirmado. GENTE PARA DE TENTAR FAZER FILME SOBRE INVOCAÇÃO DO MAL O 1 FOI ÓTIMO E CHEGA PARA INDÚSTRIA CAPITALISTA	Negativo
Tô vendo filme sem saída ótimo tem aquele ator faz o lobo do crepúsculo ele é mara	Positivo
Ouvindo uns soundtrack do crepúsculo do game of thrones da Amelie Poulain do Mozart, meu estado ta ótimo pra chorar e ficar mto trsite	Neutro
Hoje é um ótimo dia pra zoar babacas fãs de Crepúsculo	Neutro
eu gostei nenê <3 ficou bem delícia. As vezes corre um pouquinho mas tá ótimo yay. É trilha da saga de Crepúsculo ?	Neutro
felipe neto podia ter continuado fazendo video falando mal de crepúsculo que tava otimo , mas olha que bosta que deu	Negativo
Eu juro que eu não influencio, ela só é fã da Kristen, ama crepúsculo e adora assitir Grey's anatomy. Ela tem um ótimo gosto aos 7 anos.	Positivo
Meu Malvado Favorito ! Ótimo filme! E na vida real, algumas siglas tem o seu!	Positivo
Meu malvado favorito 3 tmb é ótimo	Positivo
kkkkk foi ótimo ver meu malvado favorito	Positivo
Meu malvado favorito 3 é ótimo	Positivo
espero que minha mãe chegue de viagem com um ótimo humor e me leve pra ver meu malvado favorito 3 rsrsrs	Neutro
Meu malvado favorito 3 é um ótimo filme, pelo menos as partes que eu vi	Positivo
Parabéns pra quem fez a história de Meu Malvado Favorito 3, mto bom,mas semana q vem vou ver Spider Man Home Coming e acho q vai estar ótimo	Positivo
Fui assistir Meu Malvado Favorito 3 vestida de unicórnio. Foi Ótimo +	Positivo
Querido John é ótimo chorei pacas	Positivo
ótimo momento p assistir querido john	Positivo
Assistir Querido John só pq o dia tá ótimo pra sofrer	Positivo
Um otimo homem aranha GAUAHAN	Positivo
to indo assistir homem aranha quer ser minha mary j... — Aaaa é ótimo o filme Claro	Positivo
Ótimo filme #homem_aranha _3 	Positivo
Cara homem aranha ia ser ótimo , melhor filme em cartaz	Positivo
Esse homem aranha com kauany foi ótimo kkk	Positivo
ótimo dia pra ser fã de homem aranha mores	Positivo
sobre o homem-aranha : o filme é ótimo mas eu certamente odeio o personagem agora	Positivo
Já assistiu o novo filme do homem aranha ? 	Neutro
Ontem fui assistir " Mulher-Maravilha ", e que filme ótimo , roteiro, desenvolvimento da trama é muito bem feito! #WonderWoman #DCComics	Positivo
Ana é otimo pra queimar kcal viu	Neutro
Eu achei Mulher Maravilha ótimo . Mas sou suspeita pq minhas expectativas tavam altissimas. Assisti 3x ja. Vc viu Homem Aranha?	Positivo
Gal gadot é linda O filme mulher maravilha é bom demais Mas a romantizaram. Tirando isso o filme é ótimo	Positivo
Fora a parte da minha amiguinha não ter bunda e ficar rebolando, foi otimo	Positivo
gente, mulher maravilha é otimo . porem BVS continua melhor.	Positivo
eu vou assistir mulher maravilha amanhã todo mundo fala q é ótimo fiquei curiosa	Neutro
hm não sei, talvez a DC esteja abusando um pouco dos efeitos, mulher maravilha foi um ótimo filme, porem os efeitos não foram mt bem	Neutro
Deixa pra lá, aqueles defensores de chupa rola de ladrão! Não vale a pena discutir com esquerdistas! Ótimo fds pra vc!	Negativo
OU digo: Marvel TV mandou bem. Trailer de Defensores é ótimo . Não li nada de Gifted. Nem de Legion .__. Mas ambas séries prometem. #SDCC2017	Positivo
Vamos começar o dia vendo esse ótimo trailer de OS DEFENSORES	Neutro
06:50 da manhã ótimo horário pra mandar os defensores do Roger Machado tomar no cu	Negativo
Gnt O poderoso chefinho é ótimo kkkkkkkkkkkkkk mtu bom	Positivo
" O poderoso chefinho " é ótimo !!! Mas tem muita piada pra adultos mds.	Positivo
o poderoso chefinho otimo	Positivo
Este filme o meu passado me condena e ótimo ainda mais com estes dois atores e muito bom mesmo nota 10	Positivo
Kkkkkkk adorei ele qnd foi levar a gente p festa , pique velozes e furiosos	Positivo
queria estar: me arrumando p festa do estudante estou: na fábrica olhando velozes e furiosos c minha prima	Positivo
#TBT : Gal Gadot na festa de Velozes e Furiosos , em Israel (2009).	Neutro
*chego na festa e me aproximo da anabelle e sua amiga* OI!!	Neutro
vamos! *puxo ela para a festa *	Neutro
vou me começar a me arrumar p festa *entro no banheiro e faço minhas necessidades e logo depois seco meu cabelo e saio do banheiro*+	Neutro
"Amiga tem alguém que você não goste ou ache feio pra eu não correr o risco de pegar na festa ?" Dominico, Anabelle	Neutro
alguém aq já assistiu anabelle ???? vou ter q assistir numa festa do pijama hoje e n tô preparada q medooo aaaaaa	Neutro
Minha prima quis ver anabelle ontem. To plenissima dormindo dps da festa e ela me acorda gritando com medo, ficou gritando uns 15 minutos	Neutro
a anabelle em festa parece foragida da polícia, toda hora correndo pra alguém não ver ela	Neutro
a choppada de sexta será especial, pois será minha primeira festa universitária na companhia de anabelle _bueno	Neutro
O invocação do mal 2 confepi emi festa junina LINDAAAAA	Neutro
meeeeee ou eu assistia invocação do mal ou assistia a festa da salsicha nunca mais vou comer cachorro quente	Neutro
A diferença é que invocação do mal é um filmão bom, já a festa da salsicha....	Negativo
Eu falando da festa julina "a freira do invocação do mal é legal" Glória: freira não pq tu é piranha	Negativo
Amor, podemos fazer a primeira festa da criança de Crepúsculo ? Em homenagem ao pai delas... Só que de 1 ano	Neutro
na Alpha FM tá tocando a música do Crepúsculo kkkk eu sei porque fui a uma festa de 15 anos em 2016	Neutro
POIS VAI SER A FESTA DO EDUARDO CULLEN CREPÚSCULO SANGUE P TD LADO AGR ME AGUARDEM SEUS PUTO	Neutro
Festa na casa da Ana vamos fazer uma saga de crepúsculo UAU QUE EMOÇÃO RADICAL	Neutro
ontem na festa eu vi um menino igualzinho o edward de crepúsculo bicho, ele era super pálido e o hair e o rosto viado do céu não tô brincanc	Neutro
E ontem nossa festa foi assim com meus amores: Meu Malvado Favorito 3! 	Neutro
Ganhe um ingresso para ver Meu Malvado Favorito 3 !	Neutro
vai ter festa de 18 do meu malvado favorito sim	Positivo
Qui festa oque, me convidem p ir olhar meu malvado favorito 3	Neutro
eu fui meio que de intrusa em uma festa de aniversarioefnierbfhuewrfu assisti o meu malvado favorito mana	Neutro
acabei de chegar, fui numa festa na praia e depois tava vindo p casa, mas o will resolveu ir no cine ver meu malvado favorito cmg	Neutro
não me chama p festa não, me chama p ir ver meu malvado favorito 3 pfvr	Neutro
KKKKKK tu deve me achar uma otaria devido a festa do John mas n conheço mt vc embora acredito q seja querido	Neutro
oi querido , você vai na festa da john john hoje?	Neutro
Festa linda do meu querido John ! Tema surf escolhido pela mamãe cakita pra homenagear o papai jairocos18... 	Neutro
Teve uma época que eu fui numa festa de aniversário com tema de Liga da Justiça. O Homem aranha tava lá junto com eles, não me pergunte o pq	Neutro
Pedro gosta mais do Homem Aranha e o Ben10, agora to confusa cara kkkkkkk mais a festa do Ben10 e feia, e só do homem aranha e sem graça...	Neutro
Meu irmão/cunhado/filho fazendo 18 anos na cara e faz uma festa do homem aranha	Neutro
minha prima vai fazer 3 anos e quer a festa tema " homem aranha " mas td mndo fica falando p ela "é de menino, n pode"	Neutro
e o homem aranha que tava na festa ???? divulgação do filme ta pesadissima	Neutro
superação msm é ver o afilhado q morria de medo de gente fantasiada de herói amigasso do homem aranha na festa , diza ta orgulhosa	Positivo
Festa Homem Aranha : mais de 30 lindas ideias – Inspire sua Festa 	Neutro
Vou dormir agora, porque se não, eu durmo lá na festa	Neutro
Minha fantasia da mulher maravilha pra festa do jean	Neutro
ai fode ja baixou mulher maravilha e ta mais da metade em festa da salsicha	Neutro
Minha festa vai ser da mulher maravilha .	Neutro
Kaique pensou que a festa era quinta agora, tava desesperadão Hahaha tô cascando	Neutro
Tema : Pequena Mulher Maravilha ! Festa de 6 anos da pequena Ana Clara com Giseli Barbosa 	Neutro
Minha festa vai fica linda da mulher maravilha	Neutro
rafaela ia fazer a festa da mulher maravilha , e pq eu n comprei o body, to tipo ??????	Neutro
Crc Peguei Mt Doce Na Festa Da Minha Prima , Tenho Q Separa O Meu E O Dos Meus Primos	Neutro
Meu primeiro porre forte foi no ano antes de entrar na faculdade, foi uma festa mto estilo se beber nao case . Tipo, vomitei no meu ex.	Neutro
Pqp essa festa foi estilo se beber não case !!!!!	Neutro
Te conheci na festa " se beber não case " falei mtt rápido, te vi aqui na br cortando cabelo, ficamos mo troca de curtida no tt mt gente boa	Neutro
1 ano da festa mais doida de aniversário, foi um se beber não case total em 2016 seloco	Neutro
#SE _ BEBER _ NÃO _ CASE _A_ FESTA Open Jurupinga pra elas , Sabado agora , Eu vou , vamos ?!	Neutro
Tô achando q as fotos da nossa festa serão tipo do filme " Se beber , não case ", todo mundo vai ficar PQP NAAAAOOO!?!?!?!???????	Neutro
Sábado tem ' Se beber não case - A festa '	Neutro
Hype ta mais alto que eu na minha festa pra Defensores e a nova temporada de Vikings	Neutro
E temos versão de Despacito no Defensores del Chaco! Muita festa !! #SulamericanaFOXSports	Neutro
FESTA LINDA NO DEFENSORES	Positivo
As 3 Orcrims em festa ! Defensores de Temer, Lula e Aécio se unem e comemoram a manutenção do sistema político, corrupto e perdulário do BR	Neutro
Melhor parte da festa foram os policiais chegando pra pedir pra diminuir o som e deram de cara com vários juízes, promotores e defensores kk	Neutro
' Acabei de ver a festa salsinha com o moh , é muito engraçado cr agora vamos ver o poderoso chefinho kkk	Positivo
Dia Feliz Pra quem não entendeu o tema da festa ainda ... Resposta: O poderoso chefinho Ele e esses temas...	Neutro
Fds antes da Festa do Totas tenho que ir ver o Baywatch	Neutro
Hj tá fznd 3 anos que fizemos, meu passado me condena a festa . Só loucura! Kkkkk	Neutro
Preciso ir naquela festa do American pie	Neutro
Festa de malandro tipo american pie	Neutro
Tá tipo Dubai, ressaca do carai Festa de malandro, tipo American Pie Garrafas espalhadas e aquele entra e sai…	Neutro
Festa de malandro tipo american pie	Neutro
Vês e bebes também, festa tipo American Pie	Neutro
deveriam ter desconfiado que eu era uma criança pseudo adolescente viciada em velozes e furiosos que adorava carros e michelle rodriguez	Negativo
a criançada indo assistir velozes e furiosos e os adolescente /adulto indo assistir carros 3	Neutro
MENTIRA o pior filme adolescente que eu ja vi foi loving anabelle	Negativo
guerra dos tronos e crepúsculo é tudo a mesma merda todas treta só aconteceu por causa de um namorico adolescente	Negativo
Vendo crepúsculo e pensando em coisas de casal,virei uma adolescente americana	Neutro
mas me senti num filme adolescente . tipo crepusculo .. coube com o momento.	Neutro
Pensado aqui comigo mesma... serei a única adolescente no cinema pra ver meu malvado favorito 3???	Neutro
Meu malvado favorito 3 com o gatinho hoje ele namora uma menina de 24 com cabeça de adolescente ,desculpa Brasil	Neutro
Vou no cinema ver meu malvado favorito 3, porque a idade é de adolescente , mas o coração é de criança	Neutro
RT Jovem super-herói tenta retomar vida adolescente após atuar com Vingadores. Animação ‘ Meu Malvado Favorito 3’ e comédia ‘Meus 15 anos’ …	Neutro
E acho totalmente diferente dessa versão mais adolescente aka Marvel do " Homem-Aranha : De Volta ao Lar"	Neutro
VÍDEO NOVO!!! Homem Aranha - De Volta ao Lar! O lado adolescente de Peter Parker. VEM VER!!! 	Neutro
S01E13 - Homem Aranha - De Volta ao Lar! O lado adolescente de Peter Parker	Neutro
Ah, nem falei que fui ver homem-aranha , filmaço! Esse boyzinho adolescente como protagonista ficou muito bom, hahahaha	Positivo
sobre o ator: acho brilhante o ator que fez o papel de adolescente para o homem aranha , perfeito, sem comentários negativos para ele	Positivo
povo só da rt em coisa de(+18) enquanto eu to aq curtindo pág de "se vc é adolescente ... curta nssa pag,sempre postaremos coisa desse tipo"	Neutro
tava muito besta as piadas parecia um filme pra adolescente só que ruim.. vou ter q ver mulher maravilha de novo pra desinfetar	Negativo
Nem vi mulher maravilha , mas já curti mais spidey. Super pegada de filme adolescente . Amei	Positivo
De vez em quando eu imagino que eu sou uma versão da mulher maravilha adolescente	Neutro
Depois de uma criação impecável e vibrante de Mulher Maravilha , vem esse filme adolescente do Homem-Aranha. Deixou muito a desejar.	Negativo
Só os adolescente espinhento defensores do youtuber doido on kkkkkkkkk	Negativo
A galera q ficou pistola por causa do tweet do pablo vittar tbm parou, agora é os defensores de maju trindade adolescente é merda	Neutro
Qdo eu era adolescente e ficava bêbada, ninguém passava a mão na minha cabeça. Por que ele tem defensores ? Ninguém o obrigou a beber/cheirar	Negativo
Expectativa de adolescente para a universidade: dormir tarde pq vai ser American Pie . Realidade: ir dormir tarde fazendo relatório.	Negativo
Da nem pra assistir homem aranha em paz pqp	Negativo
O filme da mulher maravilha é doido demais nuu	Positivo
no American Pie tem os Stifler , na vida real tem a família Lugon to rindo tanto	Neutro
os mesmos q inocentaram vaccari? q passaram por cima do Moro?são os mesmos mercenarios q vão julgar o lularapio?o perigo ta ai	Negativo
Perigo nada, velozes e furiosos aqui	Neutro
Tô vendo invocação do mal 2 .. o mnr .e lembra o banana kkkkk	Neutro
Será que tem perigo da minha avó morrer do coração assistindo invocação do mal 2 comigo?	Neutro
Em nenhum momento consegui sentir tensão, como se ele corresse perigo . Homem aranha que parece um mini Iron man. Essa fórmula encheu o saco	Negativo
Homem aranha , q filmao	Positivo
O homem-aranha tem o sentido aranha pra avisar ele do perigo q ele não ta vendo e eu tenho o sentido de fazer merda...	Negativo
Acho que ronda sim um senso de perigo no filme, desde a 1 cena em o homem aranha e pego de surpresa pelo abutre	Positivo
Eu achei esse novo filme do homem aranha uma merda. primeiro que: o abutre não era perigo nenhum, diferente do Lagarto, electro, venom, etc	Negativo
meu sonho é estar em perigo e o homem aranha vir me salvar	Neutro
Estranho mesmo é o fato do sentido aranha agora se chamar sentido purpurina: " no perigo , o homem aranha começa a dançar I WILL SURVIVE.	Neutro
eu namoro com a mulher maravilha e nem sabia, nunca vou correr perigo kkkkkkkkkkkkkkkkkkkkkkkkkk	Neutro
a mulher maravilha somos todas nós mulheres que enfrentamos o perigo sem medo e seguindo o nosso caminho com o amor	Positivo
Que perigo !!! Paulo depois dessa exposição pode ser facilmente violentado pelos defensores do almofadinha 	Neutro
Brasil, país mais perigoso para defensores do meio ambiente	Negativo
O River Plate chega com perigo , cruzamento na área, Alario desvia e Scocco não alcança, placar segue zerado no Defensores del Chaco!	Neutro
Já vi velozes e furiosos 7 umas mil vezes, mas não me conformo nunca pq não aparece a corrida do Toretto e o ouro carinha lá em tokio	Negativo
velozes e furiosos : corrida de velocípedes 	Neutro
é o que eu acho. E outra: e aquela corrida de carros/motos no meio do trailer? KKKKKK muito velozes e furiosos sim!	Neutro
BATTLEGROUNDS - Top Gear e Velozes e Furiosos 	Neutro
"Diretor de Velozes e Furiosos 8 diz q existe a possibilidade da franquia ir pro espaço" eles iriam postar corrida d um planeta p outro? rs	Neutro
N amor , vc anda apostando a corrida velozes e furiosos	Neutro
Um filme sobre corrida e vingança. Graças a Deus Need for Speed existe pra preencher o vazio do Velozes e Furiosos	Positivo
RT ‘ Meu Malvado Favorito 3’ e ‘Homem Aranha: De Volta ao Lar’ continuam em cartaz. O simpático carro de corrida , o lendário Relâmpago McQu…	Neutro
@srpedro faz FLASH x HOMEM ARANHA no corrida PvP por favor	Neutro
Go h3lio goooooooo da-lhe gás com força go Castroneves goooooooo vamos la Homem Aranha goooooo e muita sorte para esta corrida	Neutro
RT ‘Meu Malvado Favorito 3’ e ‘ Homem Aranha : De Volta ao Lar’ continuam em cartaz. O simpático carro de corrida , o lendário Relâmpago McQu…	Neutro
Daí a gente descobre q na verdade a corrida era uma ação promocional do novo filme do Homem Aranha	Neutro
to me sentindo a mulher maravilha depois de ter feito uma corrida de 8km. eu fico mto feliz em por meu corpo a prova de coisas q eu achava	Positivo
Eu queria muito a inscrição da Corrida da Mulher Maravilha . Mas, por achar que estava muito longe a data da corrida eu deixei pra lá	Negativo
aquela atriz de mulher maravilha que também é uma cachorra de corrida em cancha reta a galga dot	Negativo
Vi um bgl de caminhada/ corrida c tema da mulher maravilha , queria MT ir mas já esgotou os kits poxxxxxa	Negativo
Procuro amizades fitness para participar da corrida da mulher maravilha	Neutro
LC cagaram com aquele Kid Cascavel IF acho que eles fizeram ela corrida pra lançar Defensores logo Punisher tem tudo pra ser a melhor deles	Negativo
desanima, eu não me conformo com esse gol, tudo errado, a corrida do noguera, k Vanderlei, os defensores no rebote TUDO ERRADO	Negativo
Baywatch versão casa da Bia! Já estou a treinar a corrida em câmara lenta, melhor que a CJ	Positivo
O American pie da corrida é mais dhr	Positivo
tem que ter paciência pra gostar velozes e furiosos mds	Negativo
planejo de passar o dia vendo a maratona de velozes e furiosos que é meu filme fav, daí do nada perco a paciência até de assistir	Positivo
Eu O D E I O Velozes e furiosos e Caio faz questão de assistir, paciência	Negativo
Eu estava assistindo Moana que tava louca p ver, porém tava travando e n tenho paciência , tô vendo velozes e furiosos 8, de novo	Negativo
Coisas que o mundo não para de fazer: Torrar minha paciência Filme dos Transformers Filme dos Velozes e Furiosos Treta Especial do Roberto	Negativo
ai olha eu tô mt sem paciência	Negativo
na moral eu qria mt ter mais paciência pra certas coisas MAS EU NÃO TENHO	Negativo
eu tenho q ter uma paciência do caralho com certas pessoas daquele curso pq senão eu mando tomar no cu bonitinho PQ EU NÃO TENHO PACIÊNCIA	Negativo
ai pelo amor de @deus né alguém me dá paciência por favor	Negativo
eu não tô com a menor paciência pra discutir com gente homofóbica disfarçando preconceito com "minha opinião"	Negativo
- Qual o problema de não ir para o céu? - "Eu não sou um homem do céu" Invocação do Mal 3	Positivo
Minha paciência sumiu igual o fandom do Crepúsculo	Negativo
O meu primeiro e ultimo youtuber foi o Nelipe na época do Crepusculo . Só. Nao tenho paciência .	Negativo
To vendo Fallen, já pausei várias vezes, sem paciência pra essa cópia mal feita de crepúsculo .<SEP>2017-06-25	Negativo
Eu ia assistir mas não tenho paciência e troquei por meu malvado favorito ! Recomendo	Neutro
Meu Malvado Favorito 3 é bom SIM quem gostou bate palma quem não gostou paciência	Positivo
Três filmes para assistir no cinema. Só tenho paciência pra ir ver um. Homem aranha x Mulher Maravilha x Meu malvado favorito 3?	Neutro
Estava pensando em levar ela pra assistir Meu Malvado Favorito 3, mas desse jeito não dá. Não tenho paciência não	Neutro
Passando pra agradecer por terem paciência de irem comigo assistir Meu Malvado Favorito 3 @_JullyanaL @Roccodiogo_	Positivo
Eu não tenho um pingo de paciência pra ver desenhos, mas que eu vou assistir meu malvado favorito 3 eu vou. Como eu gosto desse rs	Positivo
"Vc acha que ela teria paciência pra alguém agarrada com ela?" "até o meu malvado favorito se driblou, n é possível que vc n vai tbm" -mãe	Neutro
Queria ver Meu Malvado Favorito 3 hoje, mas n sei se meu filho vai ter paciência pra assistir Cmg kk.	Negativo
Achei qualidades em mim. Lá no fundo, bem lá no fundo. Aonde poucos têm paciência de chegar, ou enxergar. - Querido john	Positivo
Mais amor ao falar. Mais paciência ao ouvir.	Neutro
Os tímidos sempre impressionam aqueles que têm paciência de conhecê-los melhor.	Positivo
Homem aranha é muito bom! Fora o ato cômico do cara cortar os créditos e depois botar de novo com o Capitão América dizendo tenham paciencia	Positivo
Pra quem Ainda não viu Homem-Aranha ... fique até o final dos créditos!! TENHA PACIÊNCIA	Neutro
O espetacular homem aranha é um dos piores filmes da marvel SIM quem não concorda com esse fato paciência	Negativo
To sem paciência pro meu pai. Me ajudem!	Negativo
Sobre a cena pós crédito de homem aranha .... Paciência é a chave	Neutro
#mulhermaravilha - Mais amor ao falar. Mais paciência ao ouvir.	Neutro
Só eu mesma pra ter essa paciência em lembrar de todos	Negativo
Não tenho paciência pra gente que só vem atrás quando convém	Negativo
Sem paciência , evitando falar com as pessoas, sinto que estou incomodando todos	Negativo
N tou cm paciência p elogios, isso n me serve de nada sinc, podia ser a mulher maravilha se n tiver bem n vou tar bem e acabou se	Negativo
0 paciência p homem falando mal de mulher maravilha	Negativo
Três filmes para assistir no cinema. Só tenho paciência pra ir ver um. Homem aranha x Mulher Maravilha x Meu malvado favorito 3?	Neutro
eu n tenho paciência pros defensores de homeopatia	Negativo
Cadê os defensores do Fred e companhia dizendo que temos que ter paciência . Esta paciência não mudou a história	Negativo
Dai-me paciência pra defensores de Zé Ricardo kkkkkkkkk	Negativo
Pessoa testa a paciência da gente até o limite. E olha q/ meu limite é longo. Agora será tolerância zero p/ defensores de FDP c/o o prefeito	Negativo
