Esperando vc falar "quero assistir um pipocao so explosao , porrada e testosterona" pra levar velozes e furiosos	Positivo
tipo velozes e furiosos q os cara ja desistiu dos carro e agr so quer sabe de porrada e explosao	Negativo
ontem eu assisti o velozes e furiosos em english ta lgd mas porra ali e so luta e pa e tinha mais explosao q dialogo entao tava suave	Positivo
Meu malvado favorito 3 e explosao de fofura! Eu amo demais hauehsksjdjshd	Positivo
explosao de tnts, era jurassica, encantando coisas, minerando, caindo na lava, parkour, luta, batman vs coringa, homem aranha vs venom	Positivo
esse novo homem aranha o diretor diz que ta chei de ideia... ja comeca errado ai, todo mundo sabe que cinema e explosao carro e mulheril	Negativo
Homem-Aranha de Andrew Garfield acharam exagero a explosao no ceu com o "virus" Lagarto. No novo o pia vira um aviao com a teia e ta td ok!	Negativo
@DanielSFurlan @caitomainier nao assistam homem aranha . Pouca cena de explosao , muito dialogo adolescente e nenhuma cena de alta velocidade	Negativo
eu+voce+pizza+coca-cola+ homem-aranha de volta ao lar= explosao de emocoes	Positivo
@benjaminback Vc viu o comercial de um banco? Quebra tabus, uma menina, futebol e a explosao do GOL! #mulhermaravilha #mulhernofutebol	Neutro
Confirmaram Mulher Maravilha 2	Neutro
na hora que doomsday solta uma explosao o batman sai correndo pra de tras do escudo da mulher maravilha KKKKKKKKKKKKKKKKKKKKKKKK	Neutro
do jeito que e a briga entre defensores do frio x amantes do calor parece que se chegar num consenso o clima vai ser aquele pra sempre	Neutro
Defensores da Cersei passem mais vergonha e por favor n tentem matar ngm em uma explosao	Neutro
mano baywatch eh tao bom serio assistam tem mulher gostosa the rock zac efron se fudendo explosao destruicao em massa annabeth do percy j.	Positivo
Proofe! Seria certo associar os cangaceiros a uma ideia de mercenarios ? Manda beijo aqui pro Sul!! #proenemaovivo @marcelolameirao	Neutro
beijo estilo velozes e furiosos	Neutro
obrigada irma *levanto e beijo o rosto da anabelle , me sento de novo*	Positivo
Um beijo pra quem sonhou com a freira do Invocacao do Mal essa noite e quase morreu de infarto kkkkkkkkk	Positivo
Se eu fosse a Bela do crepusculo n ia ter filme pq amo tanto pao de alho q ia matar meu namorado-vampiro no primeiro beijo	Positivo
Meta de vida e ir com a cremosa na roda gigante e dar aquele beijo do crepusculo laa no topo	Neutro
Quem nasceu Crepusculo ja mais sera Harry Potter. Um beijo de luz pros haters #HarryPotter20	Neutro
Vou tomar banho e ir pro cinema ver Meu Malvado Favorito , beijo .	Neutro
Quer me agradar e me dar beijo na testa, Deus eu fico igual a menininha do meu malvado favorito	Positivo
Um beijo pra quem desistiu da prova de metodos e ta assistindo Meu Malvado Favorito	Positivo
@Letzz12 queria dizer q te odeio por nao ir assistir comigo meu malvado favorito 3, beijo	Neutro
Queria dizer que assisti meu malvado favorito 3, e fiquei apaixonada, beijo beijo	Positivo
hoje eu so queria pegar essa quinta do beijo e assistir a estreia do meu malvado favorito	Positivo
Sdds do beijo dela	Neutro
 Me da um beijo ? Mas eu to gripado.  Deixa de besteira.  E serio.  Na saude e na doenca, lembra?''  Querido John .	Neutro
 Me da um beijo ? Mas eu to gripado.  Deixa de besteira.  E serio.  Na saude e na doenca, lembra?'  Querido John .	Neutro
HAHAHAHAHAHAHAHA UM BEIJO DE HOMEM ARANHA SUA CAVALA	Neutro
"Eu sempre quis dar beijo de homem aranha " kkkkkkk	Neutro
minha amiga ta assistindo the oc e acabou de terminar um ep que teve referencia do beijo de homem aranha fiquei apaixonada que fofo	Positivo
oi bebe me da um beijo pea cada vez que a globo passou homem aranha	Neutro
se eu morrer de passar mal dps das coisas q comi pelo menos vou em paz por saber q cumpri minha meta de dar um beijo estilo homem aranha	Positivo
Grey Worm mandou um beijo pra Mulher Maravilha . O amor e nossa maior fragilidade, e o q motiva nosso heroismo.	Positivo
Mulher maravilha , eu te amo muito , voce nao faz ideia do bem que me faz, do seu sorriso. Me manda um beijo please	Positivo
Beijo tia vera	Positivo
Acho que eu tava quase te deixando O seu beijo sempre acaba complicando Vou ficar mais um pouquinho por enquanto	Positivo
Cada foto que eu curto eu beijo a tela do celular, se fosse personagem de um desenho seria a mulher maravilha	Neutro
Poderiam ter trocado a atriz americana por voce para atuar no filme Mulher Maravilha , 1000 vezes melhor! Bom final de semana! beijo	Negativo
um beijo pra quem administra as contas dos defensores no twitter	Positivo
Boa tarde minha princesa manda um beijo pra o grupo defensores da emilly	Neutro
vou ir assistir o poderoso chefinho , beijo amores	Neutro
Estadio nao tem culpa, tem que quebrar carro dos jogadores e diretoria, mercenarios do caralho...	Negativo
Tem que quebrar o carro de qtos jogadores/ mercenarios pra essas merdas jogarem?	Negativo
Esse grupo precisa de um choque quem nao se esforca corta salario time de mercenarios estao puxando o carro	Negativo
Eu achava que eu andava rapido com carro , mas seu Henrique e velozes e furiosos naa ruazinhas ahahah	Neutro
Com esse preco da gasolina o proximo velozes e furiosos vai ser so com carro 1.0	Negativo
o que voces acham sobre velozes e furiosos antes eles eram ladroes de carro e agora eles se tornaram agentes especiais rss	Neutro
meu sonho de princesa e participar de um racha igual desses filmes " velozes e furiosos " com um carro bem foda e todo rosinha	Neutro
menino sla.. eu acho muito humor de hetero.. ai coloca os carro e mulher gostosa no meio parece que to vendo velozes e furiosos .. gosto nao	Negativo
Confesso que depois que comecei a dirigir e comprei meu carro , um dos meus filmes favoritos e velozes e furiosos , nem vou dizer o porque	Positivo
Depois sonhei que eu ia pro cinema assistir um filme q eu nao lembro, ai aparecia a anabelle dirigindo um carro pra promo o filme ?????	Neutro
*entro, coloco o cinto e ligo o carro * vamos? *ligo o som e sigo para a escola*	Neutro
*respiro fundo* vai dar tudo certo *rio e vou em direcao ao meu carro e coloco minhas malas na mala do carro * vamos malia traz sua mala	Neutro
acordei atrasada, o pneu do carro furou, fui arrumar e tive que trocar os dois dianteiros, fiquei mais de 1 hra na borracharia, q dia ein	Negativo
Kelly disse que carro e com k, mds kkkkkkkkkkkkkkkkkkkkkkkkk	Neutro
Pegar o carro amanha e levar os menino no cinema ve meu malvado favorito	Neutro
Quero ir no cinema assistir meu malvado favorito 3 com meu irmao, porem nao tenho carro e o shopping continente e longe	Negativo
meu carro malvado favorito 6	Neutro
Amanha vou ir pra Guarapuava com a mae pra fazer revisao do carro e assistir meu malvado favorito 3 com meu irmao	Neutro
Carro 3, homem aranha, e agora meu malvado favorito quem aguenta ? So meu namorado mesmo	Positivo
Tenho q ir ver logo meu malvado favorito e carro 3 mlk	Positivo
RT  Meu Malvado Favorito 3 e Homem Aranha: De Volta ao Lar continuam em cartaz. O simpatico carro de corrida, o lendario Relampago McQu...	Neutro
to doido p ver meu malvado favorito no cinema mano, tomara q o carro do meu pai fique pronto logo kkk	Positivo
Meus pais falaram que iamos assistir Homem-Aranha mas quando chego no carro descubro que vamos assistir outro filme	Negativo
aquele momento q ce ta largada no sofa comendo salgadinho mexendo no celular, toca a musica da mulher maravilha no carro de som na rua	Positivo
o famoso carro da mulher maravilha	Neutro
Vou pegar o carro hoje, meu Deus nem acredito	Positivo
To sendo mas invisivel que o carro da mulher maravilha	Negativo
Minha mae saiu do cinema dps de ver mulher maravilha cantando pneu e falando que o carro tava cheio de fogo	Positivo
Hoje passou um carro e gritou "olha la a mulher maravilha " kkkk eu ri mt	Positivo
ou seja, agora vou sair na rua correndo igual o usain bolt e se vier um carro eu vou virar a mulher maravilha e voar, pq e o q da p fazer	Positivo
Estamos tipo se beber nao case ... Descobrir que abastecemos o carro 2:30 da manha ou seje esse horario minha irma ja nao tinha carteira!	Neutro
Ano passado teve os defensores de vidraca do Beira-Rio e de carro do Carraveta. Tem que colocar dedo na cara sim e tirar de la a forca.	Negativo
@jornal_cultura 1970 EM MEU CARRO TINHA BRASIL AME O OU DEIXE O. ACHO QUE VOU DEIXA LO NAS MAOS DOS DEFENSORES DAS DIRETAS JA	Negativo
Eu vou quebrar o carro de todos os defensores desgraca pelada	Negativo
Hoje e um daqueles dia que so quero pegar o carro , colocar um som e so parar na praia, ficar observando o mar Mas ai eu acordei	Negativo
O carro pegou fogo la no Bar celona mano kkkk	Neutro
Passando na rua, e vi o carro balancando tem gente metendo, tem gente metendo	Neutro
Vim lavar meu carro no shopping e aproveitei pra ir no cinema ....o unico filme disponivel no horario era Baywatch .	Negativo
Vcs precisam sair desse mundinho de vcs q 18 anos eh td de bom.. faculdade n eh american pie e cnh e carro n cai do ceu	Negativo
podem ate me chamarem de crazy, mais nao sabe aonde nos vai, no carro ja ta tipo have, nos ta tipo american pie ..	Neutro
Vcs precisam sair desse mundinho de vcs q 18 anos eh td de bom.. faculdade n eh american pie e cnh e carro n cai do ceu	Negativo
meu carro ja ta tipo rave nos ta tipo american pie	Positivo
Da primeira vez que vi Velozes e Furiosos eu achava que a Letty e do Dom eram irmaos. Tomei mo susto quando eles se pegaram.	Neutro
UM GATO SE TACOU NO MEU PORTAO, QUE SUSTO DO CARALHO	Negativo
levei um puta susto no trailer da Anabelle 2	Positivo
E tbm acho q esse Anabelle 2 ai vai barrar o primeiro, sdds tomar susto	Positivo
levei 3 susto assistindo o trailers de anabelle . Ja quero ir na estrela desse filme	Positivo
Anabelle ? O chamado?? Eu pego cada susto e com o Herobrine aparecendo atras do @DCZINHU e o @C0RUJ4YT gritando na serie paranormal.	Negativo
Mano..fomos pro sitio (pensa num breu) dai assistimos invocacao do mal 2...Justo na parte de susto , nao me entra um gato preto pela janela	Positivo
Acabei de olhar invocacao do mal 2.... Tomei cada susto com os meus dindos e minha mae.... Kkkkkk.....	Positivo
Acabei de assistir invocacao do mal 2, eu n senti medo, so levei susto , mas a historia em si e massa	Positivo
Eu assisti invocacao do mal 2 pela 11 vez de madrugada. Meus irmaos tudo gritando de susto e eu so rindo.	Positivo
so pq eu tomo susto nao quer dizer q seja bom KKKKKKKKKKKKKK invocacao do mal e horrivel, tanto o 1 quanto o 2	Negativo
Fui ver invocacao do mal um dia no cinema. Unico susto que eu tomei foi o preco da pipoca. 18 conto	Negativo
to assistindo invocacao do mal 2 com as gurias, millena ta deitada cmg e cada susto que ela leva ela se gruda em mim	Neutro
to assistindo invocacao do mal 2 pela milesima vez e ainda tomo susto nessa merda	Positivo
o gps do celular do meu pai ta com a voz do gru do meu malvado favorito e, toda vez eu levo um susto quando ele comeca a falar	Neutro
A mina me faz assistir meu malvado favorito e ainda toma susto com o filme, ta de sacanagem	Negativo
Tem tanto tempo que eu to usando essa mascara do homem aranha que quando eu tirar vou levar um susto com a minha cara	Positivo
Toda hora tomo susto com com esse homem aranha do Arthur voando	Negativo
O " homem-aranha " me deu um susto	Neutro
saiu um cara vestido de homem aranha da porta atras de mim, levei o maior susto	Negativo
NOSSA QUE SUSTO , PENSEI QUE FOSSE O FILME DO LIXO HOLLAND OFSDOIFJOISDFIOSDK homem-aranha pra mim so o Tobey Maguire e essa serie, desculpa	Negativo
Fui assistir homem aranha terminei assistindo a mumia, so do susto do gordinho no final valeu a pena KKKKK KKK PQP	Negativo
Eu tomei muito susto vendo homem aranha	Neutro
So eu mesmo para tomar um puta susto no cinema assistindo Homem-Aranha (odeio cena que tem um suspense)	Negativo
sobre colocar o tema de mulher maravilha como despertador: levei um puta susto	Negativo
Porque voce nao me falou que o lupus fazia mulher maravilha @leandrofreythas ? Levei um susto hahahaha	Positivo
eu me distrai assistindo doctor who e tomei um susto pensando que tinha perdido o painel de defensores , ainda bem que e so amanha	Positivo
Eu achava q faculdade era q nem american pie , tomei um susto quando entrei e vi que realmente e	Negativo
Jogadores nao sejam mercenarios e honrem a camiseta que pagam o seu salario!!! Que vexame, devolvam meu Inter pelo amor de Deus.	Negativo
vcs n tem nocao do meu amor por velozes e furiosos serio eu fico doida assistindo	Positivo
espero que nosso amor dure mais que a franquia velozes e furiosos	Positivo
" Amor vai devagar, tu acha que e pilota de Velozes e Furiosos ? Tamo no filme nao, tudo bem q vc ta careca igual o Toreto" kkkkkkkkkk	Neutro
Velozes e Furiosos 5 amor esse filme	Positivo
Se existe historia de amor mais verdadeira que a do dom e a lety no velozes e furiosos , ainda ta pra nascer	Neutro
O engracado e que ela parece a boneca anabelle , mas mesmo assim ele preferiu ela. Sera amor ?	Neutro
To assistindo" invocacao do mal 2 "com meu amor	Neutro
a mulher de invocacao do mal e erica hahn sao um casal nesse filme ui pelo amor	Neutro
Qualquer um podia estar agora assistindo comigo invocacao do mal sem ser meu irmao pq pelo amor de Deus menino fica me dando susto	Negativo
por exemplo invocacao do mal PUTA FILME BESTA PELO AMOR e o chamado tbm e idiota pra cacete VAMOS FAZER FILMES DE TERROR BONS GALERO?	Negativo
o invocacao do mal e bom! Vera farmiga meu amor <3	Positivo
Dificil,adoro filmes hehe assisto e ja me apaixono e pronto,meu nenee.egosto de varios e generos diferentes,Ironias do amor , invocacao do mal	Positivo
Eu e a banana, a banana e eu..... Uma historia de amor melhor que crepusculo 	Negativo
eu sou mt kkkkkkkkkkk detalhes e eu historia de amor melhor q crepusculo	Negativo
@ProfRFelicio e os ''''SUPER CONFIAVEIS"" sites com dominio ".wordpress", uma historia de amor melhor que Crepusculo	Negativo
passei o dia com a vida, e assistimos meu malvado favorito 3 no cinema aaaa um amor	Positivo
E te acordar nao eh tao facil meu amor hsjshs	Neutro
espero q n seja eu nea, pq ir ate o tatuape pra ver meu malvado favorito e uma prova de amor djdjskks	Positivo
Assisti meu malvado favorito hoje Que filme mais amor	Positivo
amor : Mussarela ou lanche? Maroco: Mussarela ne amor Maroco: Sem duvidas amor : Meu pai disse lanche aoxkoa Se quer guerra tera	Neutro
[24/7 18:37] amor : [24/7 18:38] Maroco: De onde esse coracao [24/7 18:38] amor : Do meu cu Carinhosa!	Neutro
Vou no paragem com meu primos ver Malvado Favorito , q amor	Positivo
Eu te prometo que tudo vai acabar antes do que imagina.  Querido John	Neutro
E que eu sou uma pessoa dificil de lidar, de conviver, de amar.  Querido John	Neutro
A gente precisa acreditar que tudo vai dar certo.  Querido John .	Positivo
Eu preciso ver muito: Querido John , Um Porto Seguro, A Vida e Morte de Charlie e ABC do Amor .	Neutro
Um espaco entre nos, Marley & eu, Um amor para recordar, Querido John , A ultima musica, A culpa e das estrelas (chorei em todos)	Positivo
Assisti Homem - Aranha com o meu amor	Positivo
Vou no cinema hoje com meu amor ver homem aranha kkkk	Neutro
Quando for assistir homem aranha , pelo amor de deus Veja os creditos	Neutro
devolve meu amor nao correspondido	Negativo
Mais amor ao falar. Mais paciencia ao ouvir.	Neutro
Quando o amor for tudo que restar, entao ai teremos tudo.	Positivo
So o riso, o amor e o prazer merecem revanche. O resto, e mais que perda de tempo ... e perda de vida.	Neutro
LK- meu amor , melhor pessoa, amo demais, bela kkk, Leaozinho e minha mulher maravilha	Positivo
Mulher-Maravilha dizendo que a guerra acaba com amor , sendo que a mesma termina enfiando a porrada em todo mundo	Negativo
"So o amor pode salvar o mundo" Mulher Maravilha	Positivo
Vou te esperar passe o tempo que for Deixe bem guardado esse nosso amor Sei que eu te mereco	Positivo
Fala a verdade ai, assume que eu ja virei amor	Neutro
Ganhei uma brusinha da mulher maravilha , muito amor por aquela camiseta	Positivo
Vamos manter o amor a Mulher-Maravilha vivo que a continuacao tem que bater bilhao e ser maior que qualquer heroi macho vivo	Positivo
Mais Agora eu sei que so o amor pode salvar de verdade o mundo.  Mulher Maravilha	Positivo
Quero deixar registrado aqui meu amor pelo filme: Se beber nao Case , e Ultima viagem a Vegas	Positivo
Se beber nao case kkjk	Positivo
Fica comigo/o melhor de mim/ amor e outras drogas/ sexo sem compromisso/ se beber nao case 2	Positivo
Bom dia aos homossexuais e defensores , a cada dia damos um passo a frente combatendo o preconceito. Toda forma de amor e justa.	Positivo
o poderoso chefinho e tao amor	Positivo
assisti o poderoso chefinho com o meu amor , esse filme e tao lindinho	Positivo
Acabamos de ver, eu e meu amor  assistindo O Poderoso Chefinho	Positivo
Como tcheca piscando louca pra fazer amor	Neutro
assisti O Poderoso Chefinho e entendi o amor que o @classic1real tem por esse filme	Positivo
Eu e meu amor estavamos assistindo o poderoso chefinho esse filme e mt fofo rs	Positivo
To vendo O poderoso chefinho , onde o personagem e a cara do Louis!!!!! Ai, que amor pqp	Positivo
Amanha vou ver Baywatch com o meu amor !!	Neutro
Amor eterno a Zac Efron #Baywatch	Positivo
eu tenho que assistir BAYWATCH pelo amor , quem marca de ver comigo	Positivo
vim assistir baywatch sozinho no cinema isso chama amor a zac efron	Positivo
Espero mt q nao tenha foto minha pelo amor de Deus pq meu passado me condena	Negativo
Eu nem vejo direito e chorei com Renato dizendo q ele precisa viver aquele amor ...ai,nao tenho estrutura pra isso... meu passado me condena	Positivo
Cansei de te dar valor FALEIIIII TCHAU E BENCA AMOR sempre que tocar isso vai vir a frase " meu passado me condena " na minha mente	Positivo
amor hoje vai passar nosso filme sabia aquele em nos somos protagonistas meu passado me condena o nome	Positivo
@vihbitler  Linda dmssss  Conheco ja nao e de hoje  " Meu passado me condena "  Um amor de pessoaaa  Fecha pra quem fecha com ela	Positivo
29- Tenho varioss mas vou tentar falar alguns, amor sem fim, o chamado (todos), piratas do Caribe, truque de mestre, meu passado me condena	Positivo
pelo amor de deus alguem vai assistir comigo meu passado me condena c o fabio e a mia mello no teatro	Neutro
Queria muito compartilhar aquele video do cara falando do amor entre pretos, mas o problema e que meu passado palmiteiro me condena .	Negativo
To assistindo american pie o livro do amor	Neutro
Vou assistir American Pie - o livro do amor na Netflix	Neutro
estou assistindo american pie o livro do amor	Neutro
American pie 7: o cu do amor	Negativo
bye bye miss american pie	Negativo
american pie >>>>> o livro do amor	Neutro
American pie o livro do amor e o melhor filme aaa	Positivo
"Filme de heroi esta saturado demais,ja ta chato" - Diz a pessoa que edta indo ver velozes e furiosos e transformers	Negativo
Vai ser um Velozes e Furiosos de super heroi	Neutro
Coisas q ja passou da hora de Hollywood parar: King Kong Planeta dos Macacos Transformers Velozes e Furiosos Filme de Heroi sem roteiro	Negativo
Top 5 filmes de heroi : -Homem Aranha 2 - Velozes E Furiosos : Tokyo Drift -O Ninja Didi E A Princesa Lili -Seguranca Nacional -Plano Real	Positivo
So falta virar super heroi agr p ficar que nem velozes e furiosos	Negativo
eu acho que minha relacao com velozes e furiosos melhorou muito quando eu aceitei que e um filme de super heroi	Positivo
Velozes e Furiosos : o filme em que ter carteira de motorista e quase ser super heroi kkkkk	Neutro
olha o heroi salvand q coisa + crepusculo	Negativo
no cinema agora: baywatch, a mumia, carros 3, meu malvado favorito 3 + 2 filmes de super heroi . ah claro tem um filme com o tom hanks tb.	Neutro
MANO PARA eu queria comprar meu malvado favorito 3, mas o idiota quis homem aranha e eu odeio filme de super heroi me ajuda	Negativo
ja vi (vini adora filme de super heroi ) .. quero ver o circulo e o meu malvado favorito :B	Negativo
De super heroi nao, miga, vamo assistir meu malvado favorito 3 <3	Neutro
RT Longa mostra o retorno do heroi ao cinema.  Meu Malvado Favorito 3, Mulher Maravilha permanecem em cartaz.	Neutro
RT Jovem super- heroi tenta retomar vida adolescente apos atuar com Vingadores. Animacao  Meu Malvado Favorito 3 e comedia Meus 15 anos ...	Neutro
Simmm homem aranha e meu heroi chodo e meu malvado favorito , animacao e Emma Watson pobre estouuuu pobre estouuuuu	Positivo
Querido john , anjos da lei, magic mike, para sempre, ela danca eu danco, o ataque, legiao perdida, anti- heroi e muitos outros, t amo gostoso	Positivo
to em duvida meu heroi preferido eh homem aranha ou flash	Positivo
mano que raiva ,,, ai eu tive que assistir homem aranha so que eu nao sou mto fa de filme de heroi	Negativo
RT @thaeps Homem-aranha sempre sendo o melhor heroi ja feito!!!	Positivo
criei expectativas pra homem-aranha nem gostei tanto assim, wonder woman fui so assistir e foi o melhor filme de super- heroi q vi esse ano	Neutro
E as intencoes do Homem Aranha sao sempre boas, por isso ele e meu heroi favorito	Positivo
Espero que esse filme dl homem aranha seja fodaaaaa pq ele e o melhor heroi do mundo	Positivo
pega deadpool ai entao, apenas com 1 heroi conseguiu bater mais que mulher maravilha	Positivo
So estranhei o momento em que se da Mulher Maravilha como exemplo de filme de super heroi bom, em contraposicao a BvS do Snydeus...	Neutro
Vamos manter o amor a Mulher-Maravilha vivo que a continuacao tem que bater bilhao e ser maior que qualquer heroi macho vivo	Positivo
Ainda tenho de assistir mulher maravilha , estou super atrasado nos filmes de super heroi . #ALigaSeUniraNoSDV	Neutro
unico filme de super heroi que engoli em tempos foi mulher maravilha e o xmen, carregando esses chatos nas costas	Negativo
Eu tenho um pouco de medo, mesmo depois de Mulher Maravilha , de um filme da DC com mais de um heroi	Negativo
Depois da obra prima de Mulher Maravilha , nao sei mais o que esperar de um filme de heroi .	Neutro
So mulher maravilha memo. Fomos assistir homem aranha meu heroi do coracao e ODIEEEEEEEEEI FORTE	Negativo
Queria que os defensores fosse um ep pra cada heroi pq ai eu podia assistir so os de jessica jones sem ter que aguentar o demolidor e etc	Negativo
Alias, unica de heroi que fico de olho. Curtia Arrow, mas virou novela ruim. Talvez, em Defensores saia algo legal tambem.	Negativo
no cinema agora: baywatch , a mumia, carros 3, meu malvado favorito 3 + 2 filmes de super heroi . ah claro tem um filme com o tom hanks tb.	Neutro
Romance - sou louco por voce Acao - os mercenarios / Nerve Terror - pesadelo /espelhos do mal Festas- Vizinhos, XOXO	Neutro
O Guto colocou velozes e furiosos 7 p gnt assistir, agora to chorando. Como vinganca vou colocar um romance	Positivo
Esses filmes de romance tao mto chato, galera paia, vou por um velozes e furiosos aq pq vin diesel e sucesso	Negativo
Como ve romance agarrada se meu namorado quando vem pra ca so quer ver velozes e furiosos 7 e filme de guerra? Nao da ne	Negativo
Acbei de ver invocacao do mal , nem parece q ja tinha visto, agora vou ver um de romance pra acabr cm clima de: me caguei tdddd	Positivo
29- romance : simplesmente acontece, suspense: hush a morte ouve, terror: invocacao do mal 1	Neutro
a gente viu invocacao do mal 2 quando as luzes se apagam esquadrao suicida e um filme de romance la que toca Imagine Dragons	Neutro
Uma historia de romance mais bosta que crepusculo	Negativo
kkkkk iludir nao eu sou livre pae, quer romance compra um livro do crepusculo kkkkk serenao	Negativo
Crepusculo seria um bom romance se nao fosse fadas e Ney Matogrosso	Negativo
A Hospedeira seria um livro 100% se nao fosse o romance meloso e o triangulo amoroso, mas a autora nao conseguiu se desprender de Crepusculo	Negativo
quer romance ? ver crepusculo rsrsrsrs	Negativo
Eu amo filmes classicos de romance , tipo titanic, Romeu e Julieta, querido john e etc	Positivo
Querido John e o melhor filme de romance	Positivo
falei que nunca mais ia assistir nenhum filme de romance , e acabei de colocar " querido John " pra assistir.. q merda!!	Negativo
Pela primeira vez voltei a assistir filme de romance e estou vendo Querido John , eu nao sei lidar com esse filme	Positivo
querido john e simplesmente acontece vao ser meus filmes de romance preferido pra sempre, serio	Positivo
eu kkkkk, meu livro fav e Harry Potter, mas de romance acho que e querido John e o seu?	Positivo
nao. Mas olha romance tem "A culpa e das estrelas" " querido John " "simplesmente acontece" "cartas pra julieta" "como se fosse a primeira vez	Neutro
Critica do meu pai ao novo filme do homem aranha : Gostei mais do primeiro Porque tinha mais romance . Ate tu pai?	Negativo
Igor falou "amor, vamos ver de volta ao lar?" ai disse "claro". Cheguei la e descobri q era homem aranha . Achei que era romance , fui trouxa.	Negativo
KKKK ta tocando bad romance no fone e eu acabei de ver um gif do homem aranha dancando, parecia q ele tava dancando lady gaga	Positivo
/222222 so troca o romance por homem aranha *	Positivo
e eu que tava vendo homem-aranha achando q era romance teen?	Negativo
o bom desse homem aranha e que n teve romance forcado igual nos outros	Positivo
me falaram que no filme da mulher maravilha tem romance e eu achando que era so ela lutando contra tudo e tals	Neutro
"Ah mas se tem nos quadrinhos..." foda-se os quadrinhos! Mulher Maravilha e muito massa pra ser ofuscada por essa baboseira de romance	Positivo
Se Batman Vs Superman ja foi confuso imagina explicar o romance do Aquaman com a mulher maravilha , explicar o Super man fracote e o BatPai	Neutro
Hj eu passei a tarde assistindo mulher maravilha e depois filme de romance , chorando horrores por sinal	Positivo
ela eh linda miss miss miss nosso lance daria um filme mas nao eh romance eh xis xis xis	Positivo
Mulher maravilha foi um filme otimo Seria melhor sem o romance mas fora isso foi otimo	Positivo
um insuportavel, mega sem graca. Espero que no filme Liga da Justica nao tenha muito foco no romance dele com a mulher maravilha	Negativo
Meu amigo dando pala deu revoltado com o romance forcado do filme da mulher maravilha	Negativo
zach galifianakis(gordo do se beber nao case ) e o melhor tanto em drama, romance ou comedia,ja amava esse gordo,depois desse filme slc	Positivo
Cade nossa comedia misturada cm suspense e romance ? ( Se beber nao case e mt baun)	Positivo
tem que ter romance ... Nao afetando o plot dos defensores , ta ok. E o unico que to no aguardo.	Neutro
velozes e furiosos , melhores filmessss	Positivo
o ano e 2054 o mundo esta em guerra falta de recurso desigualdade social facismo velozes e furiosos 31 estreia	Neutro
Velozes e Furiosos : Guerra Corrida nas estrelas	Neutro
guerra dos tronos e crepusculo e tudo a mesma merda todas treta so aconteceu por causa de um namorico adolescente	Negativo
acabei de ver o ultimo filme do crepusculo e to chateado q a guerra final foi so uma visao	Negativo
JESUS! eu nao lembro do final de crepusculo , so lembro da guerra que ia ter mas a Alice mostrou pro cara que ele ia morrer	Neutro
Fui com minha melhor amiga ver meu malvado favorito 03 e domingo vamos com os meninos ver transformes	Neutro
Vou ir ver meu malvado favorito 03 com minha melhor amiga amanha	Neutro
Nossa e homem aranha carros meu malvado favorito vai lancar agora aquele no limite da fuga, vai lancar um de guerra tambem tanto filme	Neutro
Meu malvado favorito 3 e muito bom sissjsjsnsis	Positivo
Quero assistir Meu malvado favorito 3	Positivo
Pensei que a primeira cena do Homem-aranha em Guerra Finita seria uma longa conversa do Peter com a Tia May.	Neutro
meu afilhado tinha pedido boneco do venom com lingua pra fora eu dei e agora ele falou q quer o homem aranha da guerra civil	Neutro
Eu desisti desses filmes desde guerra civil, so vi mulher Maravilha no cinema pq pra dar errado a Warner tinha que se superar	Neutro
Mulher-Maravilha dizendo que a guerra acaba com amor, sendo que a mesma termina enfiando a porrada em todo mundo	Neutro
Ja podemos falar que o filme da Mulher Maravilha nao era tao bom assim?	Negativo
agora nao sei se vou de mulher maravilha ou guerra civil	Neutro
Passar a madrugada assistindo filme de guerra so reforca a minha vontade de ser militar. Mas o Brasil nao da valor aos seus defensores .	Neutro
Assisti velozes e furiosos 8 agr e QUE FILME! Final emocionante	Positivo
E sempre emocionante assistir velozes e furiosos 7	Positivo
achei carros 3 mais emocionante que velozes e furiosos 8	Neutro
Essa musica da trilha de velozes e furiosos e muito emocionante.	Positivo
Ainda estao pra fazer cena mais emocionante que a cena final de Velozes e Furiosos 7.	Positivo
Agr eu to so o Vin Diesel e o banho e o Paul Walker naquela emocionante cena final de Velozes e Furiosos em que cada um segue pra um lado	Neutro
Assiste Anabelle no cinema pra voce ver hauahuaahua mais emocionante que a barca do hopi hari, coracao para umas 10 vezes	Positivo
Jogo ta mais emocionante do que o final de crepusculo	Negativo
Final do " meu malvado favorito 2 " emocionante	Positivo
Homem-Aranha foi um excelente filme, porem Carros 3 conseuiu ser bem mais emocionante !	Neutro
ver a abertura da marvel tocando a musica tema do homem aranha no cinema foi muito emocionante	Positivo
Homem aranha era mais legal e emocionante no tempo do GIBI quem e desta epoca vai lembrar. Hoje e muito fajuta as historias,	Negativo
O filme e foda, e beirando a perfeicao, e engracado, tem acao, e emocionante , e O HOMEM-ARANHA !	Positivo
E o comeco do filme com a musica do homem aranha ? NOSSAAAAAAAAA... ja tinha visto aqui mas no cinema e.. EMOCIONANTE !!	Positivo
Amei demais Spider Man Homecoming! Filme divertido, emocionante , bem escrito, o Homem-Aranha mais verdadeiro que ja vi no cinema!	Positivo
Hoje foi a segunda vez que eu vi homem aranha , nao foi tao emocionante como na primeira vez	Neutro
Vim aqui dizer o quanto o filme da Mulher Maravilha e maravilhoso, perfeito, lindo, emocionante , e me deixou sem palavras depois #chorei	Positivo
Fui no praia assistir meu malvado favorito 3 c direito a muita pipoca, risada e a familia toda reunida qro mas o que?!	Positivo
Gente, vi o filme de mulher maravilha e puta que pariu, representatividade importa pra caralho, chorei na cena da praia , mulheres fodas!	Positivo
Filme de super heroi nao e muito minha praia entao fui esperando nada de mulher maravilha e meus amigos, ganhou meu core	Positivo
Cara, ver essa galera lutando em equipe , o homem-aranha junto, caraca, e tudo muito surreal	Positivo
So queria dizer que amo os Defensores demais e to surtando com o novo trailer! QUE EQUIPE DA PORRAAA	Positivo
Teve drama, teve humor, teve luta , teve o classico e moderno ao mesmo tempo homem aranha FOI UMA EXPERIENCIA UNICA	Positivo
A mulher maravilha e a unica da liga da justica que luta no estilo break dance	Neutro
ja assistiu aquele que luta todas contra a mulher maravilha ? e o melhor bicho	Positivo
Essa mulher maravilha e muito maravilhosa mesmo! Luta , luta , luta e o cabelo continua ali, impecavel!	Positivo
Porem, acho que os Defensores pode ter uma pegada muito melhor, porque alem de ter mais tempo nao precisa focar so na luta principal	Negativo
Ai mano, quero ver meu malvado favorito 3	Positivo
meu bebe me levou para ver meu malvado favorito , nem gostei	Negativo
Sobre o filme O Poderoso Chefinho : Eu sou o bebe grandao que tanka e come biscoito. HAHAEHAUEHEA foda !	Positivo
Assisti ontem o Boss Baby/ Poderoso Chefinho e pelo que entendi e que [SPOILER] o primeiro bebe morre, dai o outro e um segundo irmaozinho+	Negativo
"Biscoito e para quem vende". Divertido e inteligente! O Poderoso Chefinho - DVD Um bebe falante que usa terno...	Neutro
- o poderoso chefinho (ok) - casamento grego 2 (ok) - o bebe de Bridget Jones (ok) 	Positivo
Eu fui assistir o poderoso chefinho , isso quer dizer que eu sou o bebe mandao?	Neutro
O PODEROSO CHEFINHO Disponivel para locacao na Planeta DVD Livraria. Um bebe falante que usa...	Neutro
A DC e horrivel pra fazer filme.	Negativo
[7/11, 21:45] carly: to veno american pie [7/11, 21:52] mamis: Ta na hora de bebe dormir! [7/11, 21:52] carly: sou um bebe que faz bebe flor	Neutro
Na vida eu sou aquele cara do american pie q e certinho e bonitinho, mas quando bebe vai parar la no haiti e volta c uma crianca	Neutro
Pior e os caras dizendo que o filme era horrivel ...nao tem capacidade mental de entender Velozes e furiosos e querem dar opiniao sobre esse	Negativo
achei o teaser de jogador No 1 tao horrivel . serei muito criticado, mas que bosta e uma mistura de velozes e furiosos com transformes, tchau	Negativo
tentando ver velozes e furiosos 7 pelo tel, horrivel kk	Negativo
E tambem faz essa coisa horrivel chamada Iva que assiste Velozes e Furiosos sempre que sai no cinema.	Negativo
TWD e igual Velozes e Furiosos : e horrivel , ninguem gosta mas tem 95 continuacoes/temporadas	Negativo
minha mae ta num velozes e furiosos sem oculos e caindo uma chuva horrivel E nois se eu sair viva	Negativo
seria melhor se fosse ele, eu acho, porque foi aquela musica horrivel de chata a primeira ouvida de Velozes e Furiosos	Negativo
+ ( velozes e furiosos ), como tem pouca sessao pra muito filme, um ou outro nao passa aqui mas tirando o 3D que e horrivel e isso ai e 10/10	Negativo
Cara tive um sonho horrivel com a anabelle	Negativo
POR QUE EU IA TE RECOMENDAR ANABELLE ? AQUELE FILME E HORRIVEL 	Negativo
so pq eu tomo susto nao quer dizer q seja bom KKKKKKKKKKKKKK invocacao do mal e horrivel , tanto o 1 quanto o 2	Negativo
Dia horrivel pra escolher assistir invocacao do mal 2	Negativo
O boneco do mal (da medo pra krl) Invocacao do mal 2 (da so uns sustinhos) NAO ASSISTE OUIJA, O FINAL E HORRIVEL (pelo menos eu achei)	Negativo
Eu gosto de invocacao do mal tambem, os dois!!	Positivo
eu sonhei todo o filme invocacao do mal cmo se eu tivesse vivendo ele ou vendo dnv e foi horrivel	Negativo
O amor de Ze Ricardo pelo Marcio Araujo dava uma trilogia horrivel , estilo Crepusculo	Negativo
Crepusculo e horrivel , aquilo nao e um vampiro, e uma fada e isso!	Negativo
Que filme horrivel , vou chamar de Crepusculo	Negativo
Esse tempo melancolico chuvoso e horrivel , parece que to preso no filme Crepusculo	Negativo
esse cara e horrivel mano nao tem expressao nao tem nada parece a kristen stewart em crepusculo	Negativo
gente desculpa eu to rindo de vcs falando que choraram assistindo crepusculo eu so uma pessoa horrivel eu sei	Negativo
"Ai crepusculo e horrivel " "Ai e de menininha" Ta achando ruim n le Eu vou continuar gostando Vai toma no cu Obrigada	Positivo
Como eu ja gostei de crepusculo gente?? Q saga mais horrivel	Negativo
Que morte horrivel . Filme podre  assistindo Meu Malvado Favorito 3	Negativo
mano, e horrivel ! o novo meu malvado favorito tambem, tudo uma bosta! 	Negativo
Nao faz isso, o filme e horrivel , assiste meu malvado favorito 3	Neutro
Nao sei se sou uma pessoa horrivel por isso mas eu nao gostei muito de meu malvado favorito 3 nao	Negativo
Eu vi com a Leticia sabado, achei horrivel kkkkkkk e melhor tu ver carros ou meu malvado favorito	Neutro
Meu Malvado Favorito 3 e horrivel , Jesus!!!!!	Negativo
Meu malvado favorito e horrivel ... Morte aos Minions	Negativo
Aquela duvida horrivel em assistir Meu malvado favorito 3 ou Carros 3... mds qual eu escolho rindo de nervoso	Neutro
E se faz merda na primeira vez fica o horrivel pra sempre	Negativo
Horrivel ter que ler isto. O cara cantava com a alma	Negativo
John volta pro 169 , s2 Amor  Pretendo .. Motivos, notas horrivel	Neutro
A adaptacao de Querido John ficou horrivel .... sorry not sorry	Negativo
Homem aranha e muito bom, mas que dublagem horrivel irmaozinho	Positivo
homem aranha que final horrivel	Negativo
Meu deus, quem disse que o novo filme do Homem-Aranha e bom? Que filme horrivel !!!!	Negativo
Voces vao me desculpar, mas Homem Aranha 3 e horrivel	Negativo
Esse jogo do Homem Aranha novo parece muito legal, tirando o fato de q parece que e horrivel voar com as teias. Entao, nao parece tao legal	Positivo
Ontem fui assistir homem aranha em 3D sai com uma dor de cabeca horrivel	Negativo
Homem aranha ta horrivel	Negativo
Homem aranha lesadao, ficw com uma camera gravando tudo, com umq fantasia horrivel	Negativo
Tu e horrivel  Se apresenta ai entao, mulher Maravilha 	Neutro
sim e horrivel lutar contra ele bicho sempre perco so consigo ganhar dele com a mulher maravilha	Neutro
Definitivamente, nunca vou gostar de filmes de super herois, com excecao da trilogia Batman do Nolan. " Mulher Maravilha " e HORRIVEL .	Negativo
Os unicos filmes da DC que prestaram foram Batman (a serie de Cavaleiro das Trevas) e Mulher Maravilha .	Positivo
eu tenho, te entendo e horrivel , ruim mesmo e qnd da falta de ar	Negativo
E horrivel nao ter fotos p postar hahahaha	Negativo
O tipo de homem representado por esse marido da Lilia Cabral e horrivel . Fazer que e para agradar burros, nao e bom. #AForcadoQuerer	Negativo
Tambem nao quero Mulher Maravilha mudando, nem Lara Croft, muito menos Black Mamba de Kill Bill. Descaracterizar personagem e horrivel	Negativo
Eu ficava indignado com os defensores do Mancini, o Jandrei e o maior exemplo de como ele era horrivel	Negativo
E horrivel saber qual e o verdadeiro objetivo de alguns defensores do aquecimento global... #tojuntocomoRicardoFelicio	Neutro
Ta legal que eu sou um dos defensores de que a Diana precisa de um uniforme melhor , mas esse do Straza e horrivel de tudo	Negativo
FLAMENGO passando vergonha no brasileiro, e vejo os defensores de jogadores atuando por aqui, time horrivel , lampejos de jogos bons.	Negativo
So imagino como sera os defensores com esse punho de ferro horrivel	Negativo
eu achei horrivel dormi em quase todos os ep mano vi td so por causa de defensores	Negativo
Comecei a assitir esse filme Poderoso Chefinho e nao conseguir terminar de assistir porque o comeco ja e horrivel	Negativo
meu deus eu vi a atuacao dessa mulher em baywatch e foi horrivel	Negativo
Voce me condena pelo meu passado horrivel , e me julga pelas atitudes do presente.	Neutro
Campari e igual filme ruim otimo tipo Mercenarios	Positivo
E um filme ruim ruim, Breno, nao e um filme ruim foda de otimo como, por exemplo, Mercenarios .	Positivo
opaaaaa, eai gente pra quem curti tbm um otimo programa pra hoje os mercenarios !!!!	Positivo
ah nao vou precisar vir com o carro igual velozes e furiosos otimo sem multas pra mim, espero que esses  problemas  nao sejam graves bj	Neutro
Gostei do filme Velozes e furiosos 8, e otimo .	Positivo
acho velozes e furiosos otimo mas ta na hora de acabar	Positivo
Ca estou eu vendo Velozes e Furiosos 8 logo depois de ter visto Orphan Black tudo otimo pra um domingo	Neutro
VELOZES E FURIOSOS 8 EH OTIMO	Positivo
Quando vejo alguem falando que velozes e furiosos e um otimo filme	Positivo
Que filmao da porra velozes e furiosos 8, bem surreal, mas continua otimo kk	Positivo
E se Velozes e Furiosos fosse no Brasil? Seria Velozes e arretados..	Neutro
Otimo diretor que escolheram pro Shazam. Quando as Luzes se apagam e foda e Anabelle 2 parece ser bem bom.	Positivo
Annabelle: A Criacao do Mal ta mais pra Invocacao do Mal 1 e 2 q pro primeiro Annabelle, o q e otimo . Parada tensa. #ScareDiego #Annabelle	Positivo
invocacao do mal eh otimo	Positivo
invocacao do mal nd barra, esse filme e otimo	Positivo
Invocacao do mal e otimo , filme de terror e maravilhoso	Positivo
Invocacao do mal 3 eh confirmado. GENTE PARA DE TENTAR FAZER FILME SOBRE INVOCACAO DO MAL O 1 FOI OTIMO E CHEGA PARA INDUSTRIA CAPITALISTA	Negativo
To vendo filme sem saida otimo tem aquele ator faz o lobo do crepusculo ele e mara	Positivo
Ouvindo uns soundtrack do crepusculo do game of thrones da Amelie Poulain do Mozart, meu estado ta otimo pra chorar e ficar mto trsite	Neutro
Hoje e um otimo dia pra zoar babacas fas de Crepusculo	Neutro
eu gostei nene <3 ficou bem delicia. As vezes corre um pouquinho mas ta otimo yay. E trilha da saga de Crepusculo ?	Neutro
felipe neto podia ter continuado fazendo video falando mal de crepusculo que tava otimo , mas olha que bosta que deu	Negativo
Eu juro que eu nao influencio, ela so e fa da Kristen, ama crepusculo e adora assitir Grey's anatomy. Ela tem um otimo gosto aos 7 anos.	Positivo
Meu Malvado Favorito ! Otimo filme! E na vida real, algumas siglas tem o seu!	Positivo
Meu malvado favorito 3 tmb e otimo	Positivo
kkkkk foi otimo ver meu malvado favorito	Positivo
Meu malvado favorito 3 e otimo	Positivo
espero que minha mae chegue de viagem com um otimo humor e me leve pra ver meu malvado favorito 3 rsrsrs	Neutro
Meu malvado favorito 3 e um otimo filme, pelo menos as partes que eu vi	Positivo
Parabens pra quem fez a historia de Meu Malvado Favorito 3, mto bom,mas semana q vem vou ver Spider Man Home Coming e acho q vai estar otimo	Positivo
Fui assistir Meu Malvado Favorito 3 vestida de unicornio. Foi Otimo +	Positivo
Querido John e otimo chorei pacas	Positivo
otimo momento p assistir querido john	Positivo
Assistir Querido John so pq o dia ta otimo pra sofrer	Positivo
Um otimo homem aranha GAUAHAN	Positivo
to indo assistir homem aranha quer ser minha mary j...  Aaaa e otimo o filme Claro	Positivo
Otimo filme #homem_aranha _3 	Positivo
Cara homem aranha ia ser otimo , melhor filme em cartaz	Positivo
Esse homem aranha com kauany foi otimo kkk	Positivo
otimo dia pra ser fa de homem aranha mores	Positivo
sobre o homem-aranha : o filme e otimo mas eu certamente odeio o personagem agora	Positivo
Ja assistiu o novo filme do homem aranha ? 	Neutro
Ontem fui assistir " Mulher-Maravilha ", e que filme otimo , roteiro, desenvolvimento da trama e muito bem feito! #WonderWoman #DCComics	Positivo
Ana e otimo pra queimar kcal viu	Neutro
Eu achei Mulher Maravilha otimo . Mas sou suspeita pq minhas expectativas tavam altissimas. Assisti 3x ja. Vc viu Homem Aranha?	Positivo
Gal gadot e linda O filme mulher maravilha e bom demais Mas a romantizaram. Tirando isso o filme e otimo	Positivo
Fora a parte da minha amiguinha nao ter bunda e ficar rebolando, foi otimo	Positivo
gente, mulher maravilha e otimo . porem BVS continua melhor.	Positivo
eu vou assistir mulher maravilha amanha todo mundo fala q e otimo fiquei curiosa	Neutro
hm nao sei, talvez a DC esteja abusando um pouco dos efeitos, mulher maravilha foi um otimo filme, porem os efeitos nao foram mt bem	Neutro
Deixa pra la, aqueles defensores de chupa rola de ladrao! Nao vale a pena discutir com esquerdistas! Otimo fds pra vc!	Negativo
OU digo: Marvel TV mandou bem. Trailer de Defensores e otimo . Nao li nada de Gifted. Nem de Legion .__. Mas ambas series prometem. #SDCC2017	Positivo
Vamos comecar o dia vendo esse otimo trailer de OS DEFENSORES	Neutro
06:50 da manha otimo horario pra mandar os defensores do Roger Machado tomar no cu	Negativo
Gnt O poderoso chefinho e otimo kkkkkkkkkkkkkk mtu bom	Positivo
" O poderoso chefinho " e otimo !!! Mas tem muita piada pra adultos mds.	Positivo
o poderoso chefinho otimo	Positivo
Este filme o meu passado me condena e otimo ainda mais com estes dois atores e muito bom mesmo nota 10	Positivo
Kkkkkkk adorei ele qnd foi levar a gente p festa , pique velozes e furiosos	Positivo
queria estar: me arrumando p festa do estudante estou: na fabrica olhando velozes e furiosos c minha prima	Positivo
#TBT : Gal Gadot na festa de Velozes e Furiosos , em Israel (2009).	Neutro
*chego na festa e me aproximo da anabelle e sua amiga* OI!!	Neutro
vamos! *puxo ela para a festa *	Neutro
vou me comecar a me arrumar p festa *entro no banheiro e faco minhas necessidades e logo depois seco meu cabelo e saio do banheiro*+	Neutro
"Amiga tem alguem que voce nao goste ou ache feio pra eu nao correr o risco de pegar na festa ?" Dominico, Anabelle	Neutro
alguem aq ja assistiu anabelle ???? vou ter q assistir numa festa do pijama hoje e n to preparada q medooo aaaaaa	Neutro
Minha prima quis ver anabelle ontem. To plenissima dormindo dps da festa e ela me acorda gritando com medo, ficou gritando uns 15 minutos	Neutro
a anabelle em festa parece foragida da policia, toda hora correndo pra alguem nao ver ela	Neutro
a choppada de sexta sera especial, pois sera minha primeira festa universitaria na companhia de anabelle _bueno	Neutro
O invocacao do mal 2 confepi emi festa junina LINDAAAAA	Neutro
meeeeee ou eu assistia invocacao do mal ou assistia a festa da salsicha nunca mais vou comer cachorro quente	Neutro
A diferenca e que invocacao do mal e um filmao bom, ja a festa da salsicha....	Negativo
Eu falando da festa julina "a freira do invocacao do mal e legal" Gloria: freira nao pq tu e piranha	Negativo
Amor, podemos fazer a primeira festa da crianca de Crepusculo ? Em homenagem ao pai delas... So que de 1 ano	Neutro
na Alpha FM ta tocando a musica do Crepusculo kkkk eu sei porque fui a uma festa de 15 anos em 2016	Neutro
POIS VAI SER A FESTA DO EDUARDO CULLEN CREPUSCULO SANGUE P TD LADO AGR ME AGUARDEM SEUS PUTO	Neutro
Festa na casa da Ana vamos fazer uma saga de crepusculo UAU QUE EMOCAO RADICAL	Neutro
ontem na festa eu vi um menino igualzinho o edward de crepusculo bicho, ele era super palido e o hair e o rosto viado do ceu nao to brincanc	Neutro
E ontem nossa festa foi assim com meus amores: Meu Malvado Favorito 3! 	Neutro
Ganhe um ingresso para ver Meu Malvado Favorito 3 !	Neutro
vai ter festa de 18 do meu malvado favorito sim	Positivo
Qui festa oque, me convidem p ir olhar meu malvado favorito 3	Neutro
eu fui meio que de intrusa em uma festa de aniversarioefnierbfhuewrfu assisti o meu malvado favorito mana	Neutro
acabei de chegar, fui numa festa na praia e depois tava vindo p casa, mas o will resolveu ir no cine ver meu malvado favorito cmg	Neutro
nao me chama p festa nao, me chama p ir ver meu malvado favorito 3 pfvr	Neutro
KKKKKK tu deve me achar uma otaria devido a festa do John mas n conheco mt vc embora acredito q seja querido	Neutro
oi querido , voce vai na festa da john john hoje?	Neutro
Festa linda do meu querido John ! Tema surf escolhido pela mamae cakita pra homenagear o papai jairocos18... 	Neutro
Teve uma epoca que eu fui numa festa de aniversario com tema de Liga da Justica. O Homem aranha tava la junto com eles, nao me pergunte o pq	Neutro
Pedro gosta mais do Homem Aranha e o Ben10, agora to confusa cara kkkkkkk mais a festa do Ben10 e feia, e so do homem aranha e sem graca...	Neutro
Meu irmao/cunhado/filho fazendo 18 anos na cara e faz uma festa do homem aranha	Neutro
minha prima vai fazer 3 anos e quer a festa tema " homem aranha " mas td mndo fica falando p ela "e de menino, n pode"	Neutro
e o homem aranha que tava na festa ???? divulgacao do filme ta pesadissima	Neutro
superacao msm e ver o afilhado q morria de medo de gente fantasiada de heroi amigasso do homem aranha na festa , diza ta orgulhosa	Positivo
Festa Homem Aranha : mais de 30 lindas ideias  Inspire sua Festa 	Neutro
Vou dormir agora, porque se nao, eu durmo la na festa	Neutro
Minha fantasia da mulher maravilha pra festa do jean	Neutro
ai fode ja baixou mulher maravilha e ta mais da metade em festa da salsicha	Neutro
Minha festa vai ser da mulher maravilha .	Neutro
Kaique pensou que a festa era quinta agora, tava desesperadao Hahaha to cascando	Neutro
Tema : Pequena Mulher Maravilha ! Festa de 6 anos da pequena Ana Clara com Giseli Barbosa 	Neutro
Minha festa vai fica linda da mulher maravilha	Neutro
rafaela ia fazer a festa da mulher maravilha , e pq eu n comprei o body, to tipo ??????	Neutro
Crc Peguei Mt Doce Na Festa Da Minha Prima , Tenho Q Separa O Meu E O Dos Meus Primos	Neutro
Meu primeiro porre forte foi no ano antes de entrar na faculdade, foi uma festa mto estilo se beber nao case . Tipo, vomitei no meu ex.	Neutro
Pqp essa festa foi estilo se beber nao case !!!!!	Neutro
Te conheci na festa " se beber nao case " falei mtt rapido, te vi aqui na br cortando cabelo, ficamos mo troca de curtida no tt mt gente boa	Neutro
1 ano da festa mais doida de aniversario, foi um se beber nao case total em 2016 seloco	Neutro
#SE _ BEBER _ NAO _ CASE _A_ FESTA Open Jurupinga pra elas , Sabado agora , Eu vou , vamos ?!	Neutro
To achando q as fotos da nossa festa serao tipo do filme " Se beber , nao case ", todo mundo vai ficar PQP NAAAAOOO!?!?!?!???????	Neutro
Sabado tem ' Se beber nao case - A festa '	Neutro
Hype ta mais alto que eu na minha festa pra Defensores e a nova temporada de Vikings	Neutro
E temos versao de Despacito no Defensores del Chaco! Muita festa !! #SulamericanaFOXSports	Neutro
FESTA LINDA NO DEFENSORES	Positivo
As 3 Orcrims em festa ! Defensores de Temer, Lula e Aecio se unem e comemoram a manutencao do sistema politico, corrupto e perdulario do BR	Neutro
Melhor parte da festa foram os policiais chegando pra pedir pra diminuir o som e deram de cara com varios juizes, promotores e defensores kk	Neutro
' Acabei de ver a festa salsinha com o moh , e muito engracado cr agora vamos ver o poderoso chefinho kkk	Positivo
Dia Feliz Pra quem nao entendeu o tema da festa ainda ... Resposta: O poderoso chefinho Ele e esses temas...	Neutro
Fds antes da Festa do Totas tenho que ir ver o Baywatch	Neutro
Hj ta fznd 3 anos que fizemos, meu passado me condena a festa . So loucura! Kkkkk	Neutro
Preciso ir naquela festa do American pie	Neutro
Festa de malandro tipo american pie	Neutro
Ta tipo Dubai, ressaca do carai Festa de malandro, tipo American Pie Garrafas espalhadas e aquele entra e sai...	Neutro
Festa de malandro tipo american pie	Neutro
Ves e bebes tambem, festa tipo American Pie	Neutro
deveriam ter desconfiado que eu era uma crianca pseudo adolescente viciada em velozes e furiosos que adorava carros e michelle rodriguez	Negativo
a criancada indo assistir velozes e furiosos e os adolescente /adulto indo assistir carros 3	Neutro
MENTIRA o pior filme adolescente que eu ja vi foi loving anabelle	Negativo
guerra dos tronos e crepusculo e tudo a mesma merda todas treta so aconteceu por causa de um namorico adolescente	Negativo
Vendo crepusculo e pensando em coisas de casal,virei uma adolescente americana	Neutro
mas me senti num filme adolescente . tipo crepusculo .. coube com o momento.	Neutro
Pensado aqui comigo mesma... serei a unica adolescente no cinema pra ver meu malvado favorito 3???	Neutro
Meu malvado favorito 3 com o gatinho hoje ele namora uma menina de 24 com cabeca de adolescente ,desculpa Brasil	Neutro
Vou no cinema ver meu malvado favorito 3, porque a idade e de adolescente , mas o coracao e de crianca	Neutro
RT Jovem super-heroi tenta retomar vida adolescente apos atuar com Vingadores. Animacao  Meu Malvado Favorito 3 e comedia Meus 15 anos ...	Neutro
E acho totalmente diferente dessa versao mais adolescente aka Marvel do " Homem-Aranha : De Volta ao Lar"	Neutro
VIDEO NOVO!!! Homem Aranha - De Volta ao Lar! O lado adolescente de Peter Parker. VEM VER!!! 	Neutro
S01E13 - Homem Aranha - De Volta ao Lar! O lado adolescente de Peter Parker	Neutro
Ah, nem falei que fui ver homem-aranha , filmaco! Esse boyzinho adolescente como protagonista ficou muito bom, hahahaha	Positivo
sobre o ator: acho brilhante o ator que fez o papel de adolescente para o homem aranha , perfeito, sem comentarios negativos para ele	Positivo
povo so da rt em coisa de(+18) enquanto eu to aq curtindo pag de "se vc e adolescente ... curta nssa pag,sempre postaremos coisa desse tipo"	Neutro
tava muito besta as piadas parecia um filme pra adolescente so que ruim.. vou ter q ver mulher maravilha de novo pra desinfetar	Negativo
Nem vi mulher maravilha , mas ja curti mais spidey. Super pegada de filme adolescente . Amei	Positivo
De vez em quando eu imagino que eu sou uma versao da mulher maravilha adolescente	Neutro
Depois de uma criacao impecavel e vibrante de Mulher Maravilha , vem esse filme adolescente do Homem-Aranha. Deixou muito a desejar.	Negativo
So os adolescente espinhento defensores do youtuber doido on kkkkkkkkk	Negativo
A galera q ficou pistola por causa do tweet do pablo vittar tbm parou, agora e os defensores de maju trindade adolescente e merda	Neutro
Qdo eu era adolescente e ficava bebada, ninguem passava a mao na minha cabeca. Por que ele tem defensores ? Ninguem o obrigou a beber/cheirar	Negativo
Expectativa de adolescente para a universidade: dormir tarde pq vai ser American Pie . Realidade: ir dormir tarde fazendo relatorio.	Negativo
Da nem pra assistir homem aranha em paz pqp	Negativo
O filme da mulher maravilha e doido demais nuu	Positivo
no American Pie tem os Stifler , na vida real tem a familia Lugon to rindo tanto	Neutro
os mesmos q inocentaram vaccari? q passaram por cima do Moro?sao os mesmos mercenarios q vao julgar o lularapio?o perigo ta ai	Negativo
Perigo nada, velozes e furiosos aqui	Neutro
To vendo invocacao do mal 2 .. o mnr .e lembra o banana kkkkk	Neutro
Sera que tem perigo da minha avo morrer do coracao assistindo invocacao do mal 2 comigo?	Neutro
Em nenhum momento consegui sentir tensao, como se ele corresse perigo . Homem aranha que parece um mini Iron man. Essa formula encheu o saco	Negativo
Homem aranha , q filmao	Positivo
O homem-aranha tem o sentido aranha pra avisar ele do perigo q ele nao ta vendo e eu tenho o sentido de fazer merda...	Negativo
Acho que ronda sim um senso de perigo no filme, desde a 1 cena em o homem aranha e pego de surpresa pelo abutre	Positivo
Eu achei esse novo filme do homem aranha uma merda. primeiro que: o abutre nao era perigo nenhum, diferente do Lagarto, electro, venom, etc	Negativo
meu sonho e estar em perigo e o homem aranha vir me salvar	Neutro
Estranho mesmo e o fato do sentido aranha agora se chamar sentido purpurina: " no perigo , o homem aranha comeca a dancar I WILL SURVIVE.	Neutro
eu namoro com a mulher maravilha e nem sabia, nunca vou correr perigo kkkkkkkkkkkkkkkkkkkkkkkkkk	Neutro
a mulher maravilha somos todas nos mulheres que enfrentamos o perigo sem medo e seguindo o nosso caminho com o amor	Positivo
Que perigo !!! Paulo depois dessa exposicao pode ser facilmente violentado pelos defensores do almofadinha 	Neutro
Brasil, pais mais perigoso para defensores do meio ambiente	Negativo
O River Plate chega com perigo , cruzamento na area, Alario desvia e Scocco nao alcanca, placar segue zerado no Defensores del Chaco!	Neutro
Ja vi velozes e furiosos 7 umas mil vezes, mas nao me conformo nunca pq nao aparece a corrida do Toretto e o ouro carinha la em tokio	Negativo
velozes e furiosos : corrida de velocipedes 	Neutro
e o que eu acho. E outra: e aquela corrida de carros/motos no meio do trailer? KKKKKK muito velozes e furiosos sim!	Neutro
BATTLEGROUNDS - Top Gear e Velozes e Furiosos 	Neutro
"Diretor de Velozes e Furiosos 8 diz q existe a possibilidade da franquia ir pro espaco" eles iriam postar corrida d um planeta p outro? rs	Neutro
N amor , vc anda apostando a corrida velozes e furiosos	Neutro
Um filme sobre corrida e vinganca. Gracas a Deus Need for Speed existe pra preencher o vazio do Velozes e Furiosos	Positivo
RT  Meu Malvado Favorito 3 e Homem Aranha: De Volta ao Lar continuam em cartaz. O simpatico carro de corrida , o lendario Relampago McQu...	Neutro
@srpedro faz FLASH x HOMEM ARANHA no corrida PvP por favor	Neutro
Go h3lio goooooooo da-lhe gas com forca go Castroneves goooooooo vamos la Homem Aranha goooooo e muita sorte para esta corrida	Neutro
RT Meu Malvado Favorito 3 e  Homem Aranha : De Volta ao Lar continuam em cartaz. O simpatico carro de corrida , o lendario Relampago McQu...	Neutro
Dai a gente descobre q na verdade a corrida era uma acao promocional do novo filme do Homem Aranha	Neutro
to me sentindo a mulher maravilha depois de ter feito uma corrida de 8km. eu fico mto feliz em por meu corpo a prova de coisas q eu achava	Positivo
Eu queria muito a inscricao da Corrida da Mulher Maravilha . Mas, por achar que estava muito longe a data da corrida eu deixei pra la	Negativo
aquela atriz de mulher maravilha que tambem e uma cachorra de corrida em cancha reta a galga dot	Negativo
Vi um bgl de caminhada/ corrida c tema da mulher maravilha , queria MT ir mas ja esgotou os kits poxxxxxa	Negativo
Procuro amizades fitness para participar da corrida da mulher maravilha	Neutro
LC cagaram com aquele Kid Cascavel IF acho que eles fizeram ela corrida pra lancar Defensores logo Punisher tem tudo pra ser a melhor deles	Negativo
desanima, eu nao me conformo com esse gol, tudo errado, a corrida do noguera, k Vanderlei, os defensores no rebote TUDO ERRADO	Negativo
Baywatch versao casa da Bia! Ja estou a treinar a corrida em camara lenta, melhor que a CJ	Positivo
O American pie da corrida e mais dhr	Positivo
tem que ter paciencia pra gostar velozes e furiosos mds	Negativo
planejo de passar o dia vendo a maratona de velozes e furiosos que e meu filme fav, dai do nada perco a paciencia ate de assistir	Positivo
Eu O D E I O Velozes e furiosos e Caio faz questao de assistir, paciencia	Negativo
Eu estava assistindo Moana que tava louca p ver, porem tava travando e n tenho paciencia , to vendo velozes e furiosos 8, de novo	Negativo
Coisas que o mundo nao para de fazer: Torrar minha paciencia Filme dos Transformers Filme dos Velozes e Furiosos Treta Especial do Roberto	Negativo
ai olha eu to mt sem paciencia	Negativo
na moral eu qria mt ter mais paciencia pra certas coisas MAS EU NAO TENHO	Negativo
eu tenho q ter uma paciencia do caralho com certas pessoas daquele curso pq senao eu mando tomar no cu bonitinho PQ EU NAO TENHO PACIENCIA	Negativo
ai pelo amor de @deus ne alguem me da paciencia por favor	Negativo
eu nao to com a menor paciencia pra discutir com gente homofobica disfarcando preconceito com "minha opiniao"	Negativo
- Qual o problema de nao ir para o ceu? - "Eu nao sou um homem do ceu" Invocacao do Mal 3	Positivo
Minha paciencia sumiu igual o fandom do Crepusculo	Negativo
O meu primeiro e ultimo youtuber foi o Nelipe na epoca do Crepusculo . So. Nao tenho paciencia .	Negativo
To vendo Fallen, ja pausei varias vezes, sem paciencia pra essa copia mal feita de crepusculo .<SEP>2017-06-25	Negativo
Eu ia assistir mas nao tenho paciencia e troquei por meu malvado favorito ! Recomendo	Neutro
Meu Malvado Favorito 3 e bom SIM quem gostou bate palma quem nao gostou paciencia	Positivo
Tres filmes para assistir no cinema. So tenho paciencia pra ir ver um. Homem aranha x Mulher Maravilha x Meu malvado favorito 3?	Neutro
Estava pensando em levar ela pra assistir Meu Malvado Favorito 3, mas desse jeito nao da. Nao tenho paciencia nao	Neutro
Passando pra agradecer por terem paciencia de irem comigo assistir Meu Malvado Favorito 3 @_JullyanaL @Roccodiogo_	Positivo
Eu nao tenho um pingo de paciencia pra ver desenhos, mas que eu vou assistir meu malvado favorito 3 eu vou. Como eu gosto desse rs	Positivo
"Vc acha que ela teria paciencia pra alguem agarrada com ela?" "ate o meu malvado favorito se driblou, n e possivel que vc n vai tbm" -mae	Neutro
Queria ver Meu Malvado Favorito 3 hoje, mas n sei se meu filho vai ter paciencia pra assistir Cmg kk.	Negativo
Achei qualidades em mim. La no fundo, bem la no fundo. Aonde poucos tem paciencia de chegar, ou enxergar. - Querido john	Positivo
Mais amor ao falar. Mais paciencia ao ouvir.	Neutro
Os timidos sempre impressionam aqueles que tem paciencia de conhece-los melhor.	Positivo
Homem aranha e muito bom! Fora o ato comico do cara cortar os creditos e depois botar de novo com o Capitao America dizendo tenham paciencia	Positivo
Pra quem Ainda nao viu Homem-Aranha ... fique ate o final dos creditos!! TENHA PACIENCIA	Neutro
O espetacular homem aranha e um dos piores filmes da marvel SIM quem nao concorda com esse fato paciencia	Negativo
To sem paciencia pro meu pai. Me ajudem!	Negativo
Sobre a cena pos credito de homem aranha .... Paciencia e a chave	Neutro
#mulhermaravilha - Mais amor ao falar. Mais paciencia ao ouvir.	Neutro
So eu mesma pra ter essa paciencia em lembrar de todos	Negativo
Nao tenho paciencia pra gente que so vem atras quando convem	Negativo
Sem paciencia , evitando falar com as pessoas, sinto que estou incomodando todos	Negativo
N tou cm paciencia p elogios, isso n me serve de nada sinc, podia ser a mulher maravilha se n tiver bem n vou tar bem e acabou se	Negativo
0 paciencia p homem falando mal de mulher maravilha	Negativo
Tres filmes para assistir no cinema. So tenho paciencia pra ir ver um. Homem aranha x Mulher Maravilha x Meu malvado favorito 3?	Neutro
eu n tenho paciencia pros defensores de homeopatia	Negativo
Cade os defensores do Fred e companhia dizendo que temos que ter paciencia . Esta paciencia nao mudou a historia	Negativo
Dai-me paciencia pra defensores de Ze Ricardo kkkkkkkkk	Negativo
Pessoa testa a paciencia da gente ate o limite. E olha q/ meu limite e longo. Agora sera tolerancia zero p/ defensores de FDP c/o o prefeito	Negativo
